biography	 n. 传记
fantasy	 n. 想象(幻想)物
horror	 n. 惊恐，恐惧
abandon	 vt. 放弃，遗弃
come into view	 出现
knock sb. over	 撞倒某人
victim	 n. 受害者
once upon a time	 从前
princess	 n. 公主，王妃
criteria	 n(pl. )(评判的)标准
novelist	 n. (长篇)小说家
volcanic eruption	 火山爆发
preserve	 vt. 保护，保存
capsule	 n. 胶囊；太空舱
witness	 v. 目击
occur	 vi. 发生
tremble	 vi. 颤抖，发抖
block out	 堵住
particularly	 adv. 特别地；特定地
loss	 n. 遗失，丢失
awesome	 adj. 令人敬畏的
in a way	 从某种程度上说
rewind	 vi&vt. (rewound,rewound)倒回
architecture	 n. 建筑
authentic	 adj. 原作的；真正的
characteristic	 adj. 典型的
monument	 n. 纪念碑，纪念堂
gather	 vi&vt. 聚集
on one's side	 侧身
sorrow	 n. 悲伤，难过
sympathy	 n. 同情
burst	 vi. 爆炸；冲，闯
split up	 （使）解散；决裂
on the way to	 在去……的路上
pay rise	 增加工资
specific	 adj. 详细的；特定的
significance	 n. 重要性；意义
abnormal	 adj. 反常的，不正常的
vivid	 adj. 生动的，逼真的；丰富的
hardship	 n. 艰苦，困苦
pillar	 n. 支柱
violinist	 n. 小提琴家
name... after	 以……的名字给某人某物命名
come across	 偶然遇见
hold up	 支撑起
count on	 依靠
origin	 n. 起源，开端；出身
figure out	 理解
heather	 n. 石楠属植物
discourage	 vt. 使泄气，使灰心
end up	 以……结束，以……告终
put up with	 容忍，忍受
suffering	 n. 痛苦，困难
musical	 adj. 音乐的 n. 音乐剧，音乐片
admirable	 adj. 令人钦佩的
tease	 vt. 嘲笑，取笑
suspension bridge	 吊桥
videophone	 n. 可视电话
in particular	 特别，尤其
superb	 adj. 出色的，卓越的
severe	 adj. 严重的；严厉的
restriction	 n. 限制，约束
unbearable	 adj. 不能忍受的
stubborn	 adj. 倔强的，固执的
former	 adj. 以前的
troublesome	 adj. 引起麻烦的
straightforward	 adj. 直接的；坦率的
precise	 adj. 准确的，精确的
imitation	 n. 模仿
precious	 adj. 宝贵的，珍贵的
now that	 既然，由于
eager	 adj. 渴望的，热衷的
gradual	 adj. 逐渐的
expand	 v. 扩大，扩充
complex	 adj. 复杂的
apparent	 adj. 明显的，显而易见的
violet	 n. 紫罗兰
sweetness	 n. 甜蜜，温柔
warmth	 n. 温暖
breakthrough	 n. 突破，重大发现
uncertain	 adj. 不确定的
tiresome	 adj. 讨厌的，令人厌倦的
awkward	 adj. 笨拙的；令人不舒服的
spill	 vi&vt. 洒出，溅出
nasty	 adj. 令人不愉快的;不善良的
tense	 adj. 紧张的
dizzy	 adj. 头晕目眩的
applaud	 vi&vt. 鼓掌 vt. 称赞
clumsy	 adj. 笨拙的，不得体的
harp	 n. 竖琴
fairy	 n. 小仙子，小精灵
amuse	 vt. 逗乐，使(某人)笑
burst out laughing	 突然笑起来
giggle	 vi. 咯咯地傻笑
anecdote	 n. 轶事，趣闻
ridiculous	 adj. 荒谬的，可笑的
politician	 n. 政治家
response	 n. 回答
unbelievable	 adj. 不可置信的，极其惊人的
agency	 n. 代理处，经销处
visa	 n. 签证
my goodness	 天哪，哎呀
harmony	 n. 协调，和谐
cash a cheque	 兑现支票
withdraw	 vt. （withdrew,withdrawn）提取；撤退
forgetful	 adj. 健忘的
mature	 adj. 成熟的
overlook	 vt. 忽视
clarify	 vt. 澄清，讲清楚
delay	 n. 延误，延期
counter	 n. 柜台
agent	 n. 代理人，经销商
queue	 vi. 排队
yell	 vi. 叫喊，叫嚷
wait in line	 排队
identification	 n. 身份
sunburnt	 adj. 晒黑的
messy	 adj. 凌乱的，肮脏的
scared	 adj. 惊恐的，担惊受怕的
thriller	 n. 惊险小说(戏剧、电影)
swiftly	 adv. 迅速地
black eye	 打得鼻青脸肿
pool	 n. 台球
tournament	 n. 锦标赛，联赛
nap	 n. 小睡，打盹
border	 n. 国界，边境
psychology	 n. 心理学
acknowledge	 vt. 认可，承认
being	 n. 人；物；生物
get rid of	 处理掉，摆脱
profession	 n. 职业，专业
fool around	 胡闹，瞎弄
from time to time	 不时地
authority	 n. 权威；权力
figure	 n. 人物
campaign	 n. 运动
result in	 导致，造成
alongside	 prep. 在……旁边，与……并排
resist	 vt. 抵抗，抵制
tension	 n. 紧张，焦虑
caution	 n. 谨慎，小心
scratch	 n. 痕迹或划伤 vt. 划(破)
scold	 vt. 骂，责骂
forbid	 vt. (forbade,forbidden)禁止，不准
run into	 撞上
comedy	 n. 喜剧
comedian	 n. 喜剧演员
imitate	 vt. 模仿
put on	 假装
turn sb. off	 令人讨厌
regardless of	 不管，不顾
purely	 adv. 完全地，仅仅
universal	 adj. 通用的，普遍的；全世界的
seal	 vt. 封，密封
astonish	 vt. 使惊讶，使惊骇
saucer	 n. 茶托，茶杯碟
steak tartare	 鞑靼牛肉末
raw	 adj. 生的，未煮过的
disgusting	 adj. 厌恶的
desperate	 adj. 不顾一切的；绝望的
boarding school	 寄宿学校
obtain	 vt. 得到，获得
partly	 adv. 部分地
compensate	 vt. 补偿，赔偿
convince	 vt. 使相信
play around	 四处游戏
pull faces	 做鬼脸
rarely	 adv. 很少，难得
presence	 n. 存在；到场，出席
genius	 n. 天才
depth	 n. 深（度），纵深
scare	 vt. 使恐惧
string	 n. 绳，线
starve	 vi. 挨饿，饿死
loaf	 n. （面包的）一条
yawn	 vi. 打哈欠
tough	 adj. 艰难的；不幸的；强壮的，强健的
cross-talk	 n. 相声
component	 n. 成分，组成部分
thanks to	 多亏；由于
accomplish	 vt. 取得（成功），完成（任务）
breathless	 adj. 令人屏息的
masterpiece	 n. 杰作，名作
scenic	 adj. 自然景色的，风景优美的
superior	 adj. 高级的，上等的
sideways	 adv. 向一边，向一侧
vertical	 adj. 垂直的，竖的
adore	 vt. 敬爱，非常喜欢
rainbow	 n. 彩虹
flock	 vi. 聚集
beholder	 n. 观看者
consistent	 adj. 一致的，始终如一的
corset	 n. 紧身胸衣
woollen	 adj. 羊毛制的
shawl	 n. 披肩，围巾
tattoo	 n. 文身
slim	 vi. (通过节食、加强运动等)减肥 adj. 苗条的
overweight	 adj. 超重的，过重的
commitment	 n. 责任，义务；承诺
die out	 完全消失，灭绝
accompany	 vt. 伴随，陪同
range	 n. （数、量、年龄等的）变化范围
conscience	 n. 良心
inner	 adj. 内部的，里面的
subjective	 adj. 主观的
dimension	 n. 方面；度量
command	 n. 命令，指挥
tasteless	 adj. 没有味道的
botany	 n. 植物学
skateboard	 vi. 用滑板滑行
symphony	 n. 交响乐，交响曲
accessible	 adj. 容易理解的
delicate	 adj. 精美的，雅致的
tune	 n. 曲调，旋律
deliver	 vt. 递送，传送
thrill	 n. 兴奋；恐惧 v. 使兴奋
dignity	 n. 尊贵；庄严
polished	 adj. 优雅的，精致的
refresh	 vt. 消除……的疲劳，使振作精神
sentimental	 adj. 多愁善感的
shabby	 adj. 低劣的；肮脏破烂的
harsh	 adj. 刺耳的，刺眼的
chorus	 n. 合唱部分
tendency	 n. 倾向，趋势
vain	 adj. 自负的，炫耀的
lyrics	 n. 歌词
abrupt	 adj. 突然的，出其不意的
disturbing	 adj. 使人烦恼的
version	 n. 版本;说法
stuff	 n. 东西，材料
steady	 adj. 平稳的；稳定的
Christian	 adj. 基督教的
endless	 adj. 没完没了的，永无休止的
freezing	 adj. 严寒的，冰冻的
romantic	 adj. 浪漫的
tranquil	 adj. 平静的，宁静的
hoarfrost	 n. 白霜
bend	 v. （bent,bent）弄弯曲;屈服；弯腰 n. 弯曲
homesickness	 n. 想家，思乡
drown	 vi&vt. 淹没，淹死
vague	 adj. 模糊的
hoof	 n. 蹄
stout	 adj. 肥胖的
bound	 n. 一跳，一跃
oval	 adj. 卵形的，椭圆形的
bow	 n. 弓；弧形物；蝴蝶结
jerk	 n. 猛拉，猛的一动
chimney	 n. 烟囱
sleigh	 n. 雪车，雪橇
thistle	 n. 蓟（一种野生植物，叶片带刺，开紫花）
tone	 n. 语调；语气
unlike	 prep. 不像,和……不同
convey	 vt. 传达，表达
affection	 n. 爱慕，钟爱
merchant	 n. 商人
treat	 vt. 对待
trap	 vt. 诱捕，设圈套
theme	 n. 主题
manner	 n. 方式，方法
drawback	 n. 缺点，弊端
strike	 vt. （struck,struck）打；打动
striking	 adj. 引人注目的，突出的
evident	 adj. 明显的，明白的
cute	 adj. 娇小可爱的
recommend	 vt. 劝告，建议；推荐，介绍
plot	 n. 情节；小块土地
DJ	 n. 电台流行音乐主持人
hang on a second	 等一下
catalogue	 n. 商品目录
bits and pieces	 各种各样的零碎东西
childish	 adj. 孩子的，幼稚的
