questionnaire	 n. 问卷；调查表
matter	 vi. 要紧，有重大关系 n. 事情
partner	 n. 合作者，搭档
lifestyle	 n. 生活方式
shepherd	 n. 牧羊人
peaceful	 adj. 平静的；和平的
relaxing	 adj. 轻松的，放松的
stressful	 adj. 充满压力的，紧张的
suppose	 vt. 认为，猜想
series	 n. 系列节目；系列
cartoon	 n. 卡通片，动画片
talk show	 谈话节目，现场访谈
complain	 vi. 抱怨；投诉
couch	 n. 长沙发，睡椅
switch	 vt. 转换，转变
BBC	 英国广播公司
portable	 adj. 轻便的，手提(式)的
remote	 adj. 遥远的
workaholic	 n. 工作狂
paperwork	 n. 日常文书工作
alarm	 n. 警报，警告器
go off	 (铃、爆竹等)响
take	 占据
be filled with	 充满着
urgent	 adj. 急迫的，紧急的
document	 n. 公文，文件
midnight	 n. 午夜，半夜
bored	 adj. 厌烦的，不感兴趣的
stress	 n. 压力
studio	 n. 演播室；工作室
expert	 n. 专家
suffer	 v. 遭受(痛苦)，感到疼痛
pressure	 n. 压力
social	 adj. 社交的；社会的
reduce	 vt. 减少；降低
organise	 vt. 组织
diet	 n. 饮食；节食
prefer	 vt. 更喜欢；宁愿
stand	 vt. (stood，stood)忍耐，忍受
volunteer	 n. 志愿者
graduate	 vi. 毕业
minus	 adj. 零下，负
basin	 n. 水盆，脸盆
challenge	 n. 挑战
support	 vt&n. 支持；支撑
dial	 vt. 拨(电话号码)
design	 n&vt. 设计
advertisement	 n. 广告
presentation	 n. 表演；展示
solve	 vt. 解决；解答
accountant	 n. 会计，会计师
tube	 n. 地铁
crowded	 adj. 拥挤的
nearby	 adj. 附近的 adv. 在附近
otherwise	 adv. 否则；另外
forecast	 n. 预报；预测
crowd	 n. 人群，一伙人
lung	 n. 肺
sickness	 n. 疾病
distance	 n. 距离
cigar	 n. 雪茄烟
at the moment	 此刻，目前
over the years	 数年间
survey	 n. 调查
classical	 adj. 古典的
mini-skirt	 n. 迷你裙，超短裙
formal	 adj. 正式的，合礼仪的
cycle	 vi. 骑自行车
kung fu	 n. (中国)功夫
style	 n. 风格，作风
calm	 adj. 镇静的，沉着的
generous	 adj. 慷慨的，大方的
violent	 adj. 暴力的
character	 n. 人物；性格
spaceship	 n. 太空船
province	 n. 省
astronaut	 n. 宇航员
flight	 n. 飞行；航班
launch	 n. 发射
gravity	 n. 地心引力
rocket	 n. 火箭
soar	 vi. 升空，升腾
the United Nations	 联合国
explore	 vt. 探测；勘探
peacefully	 adv. 和平地，平静地
reporter	 n. 记者，通讯员
glow	 vi. 发光
atmosphere	 n. 大气；气氛
parachute	 n. 降落伞
helicopter	 n. 直升机
million	 num. 百万
wave	 vi. 挥手示意，致意
revolution	 n. 革命
found	 vt. 建立，创立
republic	 n. 共和国
light bulb	 n. 电灯泡
opinion	 n. 意见，看法，主张
personally	 adv. 就自己而言
racism	 n. 种族主义
equal	 adj. 平等的；相等的
struggle	 n. 斗争，拼搏
protest	 n. 抗议
march	 vi&n. 游行示威；行军
brilliant	 adj. 卓越的
skilful	 adj. 灵巧的，熟练的
awful	 adj. 糟糕的；极度的
useless	 adj. 差劲的；无用的
unusual	 adj. 不平常的
champion	 n. 冠军
violence	 n. 暴力，暴行
bullet	 n. 子弹
compete	 vi. 比赛，竞争
keen	 adj. 热心的，渴望的
career	 n. 职业，一生的事业
amazing	 adj. 令人惊异的
event	 n. 竞赛；事件
fortunately	 adv. 幸运地
athlete	 n. 运动员
superhero	 n. 超级英雄
afterwards	 adv. 然后，后来
superman	 n. 超人
disaster	 n. 灾难
on one's own	 独立地，独自地
promote	 vt. 促进，提升
injury	 n. 伤害，损害
give up	 放弃
come to do something	 开始(认识、理解)
pull through	 使从(受伤)中活下来；渡过难关
commit	 vt. 犯(错误)，干(坏事)
get on	 融洽相处；进展
relationship	 n. 关系
react	 vi. 反应；起化学反应
divorce	 vi. 离婚
involve	 vt. 涉及；参与
charity	 n. 慈善，施舍
quality	 n. 质量；品质
disabled	 adj. 残疾的
confident	 adj. 自信的
far too	 太…，极为…
come off it	 别胡扯
Olympic	 adj. 奥运会的
badminton	 n. 羽毛球
admire	 vt. 钦佩，羡慕
dead (right)	 adv. 完全地，绝对地
absolutely	 adv. 当然；绝对地
medal	 n. 奖章，勋章
You've got a point there.	 你所说的看来有道理。
dive	 vi&n. 跳水；潜水
graduation	 n. 毕业
scholarship	 n. 奖学金
the Mid Autumn Festival	 中秋节
wedding	 n. 婚礼
Halloween	 n. 万圣节前夕
dragon	 n. 龙
turkey	 n. 火鸡
occasion	 n. 时刻，时机
traditional	 adj. 传统的
bean paste	 豆馅
nowadays	 adv. 现今，现在
lantern	 n. 灯笼
lunar	 adj. 月球的，与月亮有关的
celebration	 n. 庆祝，庆典
power	 n. 控制力；权力
darkness	 n. 黑暗，漆黑
destroy	 vt. 破坏，毁坏
burn down	 烧毁
decorate	 vt. 装饰，布置
battery	 n. 电池
sweet dumpling	 元宵
boil	 vt&vi. 煮沸，沸腾
serve	 vt. 提供(食物)，端上(饭菜)
tradition	 n. 传统，惯例
take part in	 参与，参加
sticky	 adj. 黏的，黏性的
alcohol	 n. 酒；酒精
hot pot	 火锅
snack	 n. 小吃，快餐
reception	 n. 接待；招待会
retire	 vi. 退休
salary	 n. 薪水，工资
apply	 vi. 申请 vt. 应用
opportunity	 n. 机会
teenager	 n. 青少年
depend on	 根据，依据
smartly	 adv. 潇洒地；漂亮地
on time	 准时
bunch	 n. 串，束
congratulation	 n. 祝贺
bride	 n. 新娘
bridegroom	 n. 新郎
best man	 男傧相
ceremony	 n. 典礼，仪式
entrance	 n. 入口
invitation	 n. 请柬；邀请
even if	 即使
attend	 vt. 出席，参加
Indonesian	 adj. 印度尼西亚的
ought	 aux. 应当，应该
contribute	 vt. 捐献，贡献；促成，造成
Greek	 adj. 希腊的，希腊人的
crown	 n. 花冠，王冠
ribbon	 n. 缎带，丝带
link	 vt. 连接
carol	 n. 圣诞节颂歌
stocking	 n. 长筒女袜
seriously	 adv. 认真地；真诚地
pole	 n. 极；棒，竿
envelope	 n. 信封
calendar	 n. 日历
put up	 竖起，建造
decoration	 n. 装饰；装饰品
pudding	 n. 布丁
breast	 n. (鸟的)胸脯肉；胸部
swallow	 vt. 吞下，咽下
adult	 n. 成年人
carry on	 继续，坚持
merry	 adj. 高兴的，愉快的
production	 n. 生产，制造
needle	 n. 针
pillow	 n. 枕头
as well	 也
mat	 n. 垫子
litre	 n. 升，公升
fry	 vt. 用油煎，用油炸
unfortunately	 adv. 不幸地
mess	 n. 混乱，脏乱
