participate	 vi. 参加
fill out	 填写
evaluate	 vt. 评估，评价
arrange	 vt. 安排，准备
chimpanzee	 n. 黑猩猩
dolphin	 n. 海豚
sign	 n. 手势，符号
hunt	 v. 打猎，猎杀
actor	 n. 演员
actress	 n. 女演员
writer	 n. 作者，作家
collection	 n. 收集，收取
boxing	 n. 拳击运动
ski	 vi. 滑雪
water skiing	 n. 滑水
windsurfing	 n. 风帆滑浪
frightening	 adj. 令人惊恐的，骇人的
underwater	 adj. 在水下，供水下用的
spirit	 n. 精神
explorer	 n. 探险家
sailor	 n. 水手，海员
Viking	 n. 维京人，北欧海盗
voyage	 n. 航海；航空
ancestor	 n. 祖先，祖宗
set sail	 启航
AD	 n. 公元
further	 adv. 更远，较远
according to	 根据，依照
get into trouble	 陷入麻烦，陷入困境
persuade	 vt. 说服，劝服
make it to	 到达
in search of	 寻找，寻求
unknown	 adj. 不知道的，未知的
eventually	 adv. 最终，终于
present-day	 adj. 当今的，现代的
deed	 n. 行为，行动
journey	 n. 旅行，旅程
lecture	 n. 讲授，演讲
brake	 n. 制动器，刹车
apologise	 vi. 道歉
the Antarctic	 南极洲
pollute	 vt. 使污染
pollution	 n. 污染
over-fishing	 n. 过度捕捞
industrial	 adj. 工业的
agricultural	 adj. 农业的
chemical	 n. 化学物
ban	 vt. 禁止
altogether	 adv. 完全
handle	 vt. 对付；处理
department	 n. 部，系，局，部门
make a living	 谋生
solution	 n. 解决办法；答案
port	 n. 港口，海港
present	 vt. 演示；讲演
intelligence	 n. 智力，理解力
intelligent	 adj. 有灵性的；聪明的
Iceberg	 n. 冰山，浮冰
seal	 n. 海豹
energetic	 adj. 有活力的
penguin	 n. 企鹅
coral	 n. 珊瑚
discovery	 n. 发现
crab	 n. 蟹
educate	 vt. 教育
up-to-date	 adj. 最新的；现代的
attraction	 n. 吸引人的地方
attract	 vt. 吸引
watch out	 注意
shark	 n. 鲨鱼
discount	 n. 折扣，减价
trick	 n. 戏法，把戏
melt	 vi. 融化，熔化
measure	 vi&vt. (长度、数量)为；测量
length	 n. 长度，长
schoolboy	 n. 男生
centimetre	 n. 厘米
barrel	 n. 圆桶
whirlpool	 n. 漩涡
horrible	 adj. 可怕的；令人厌恶的
float	 vi. 漂，浮
terrify	 vt. 令人感到恐惧
escape	 vi. 逃脱，逃跑
terror	 n. 恐怖，恐惧
soul	 n. 灵魂
survive	 vi. 幸存，生存下来
all at once	 突然，忽然
recover	 vi. 恢复正常；康复
scream	 vi. (因恐惧、疼痛、兴奋等)尖声大叫
sink	 vi. (sank，sank)下沉；沉没
pick up	 取，接载
unable	 adj. 不能的，不会的
recognise	 vt. 辨认出
Oceania	 n. 大洋洲
opposite	 n. 对立的人(物)；反义词
net	 n. 网
leak	 vi. 渗漏；泄漏
stadium	 n. 运动场，体育场
debate	 n. 辩论，争论
local	 adj. 当地的，地方性的
shopkeeper	 n. 店主，店东
bay	 n. 海湾，湾
wildlife	 n. 野生生物
disagree	 vi. 不同意，意见不合
adventure	 n. 奇遇，冒险的经历
desert	 n. 沙漠，荒原 vt. 抛弃，遗弃
canoe	 vi. 乘独木舟 n. 独木舟
safari	 n. (尤指在东非或中非的)游猎，探险旅行
hike	 v&n. 徒步旅行，远足
take off	 起飞
presenter	 n. 节目主持人
major	 adj. 较重要的；较严重的
wild	 adj. 野生的；狂热的
tiring	 adj. 令人疲劳的
raft	 n. 木排，木筏
extra	 adj. 特别的；额外的
optional	 adj. 可选择的，非强制的
horizon	 n. 地平线
organization	 n. 团体，组织，机构
uncomfortable	 adj. 不舒服的，不自在的
route	 n. 路程，路线
porter	 n. 行李搬运工
luggage	 n. 行李
accommodation	 n. 住所，住处
hostel	 n. 旅社，招待所
maximum	 adj. 最大的，最多的
altitude	 n. 高度，海拔
right now	 就在此刻
differ	 vi. 不同于，有区别
footprint	 n. 脚印，足迹
anxious	 adj. 忧虑的，担心的
extreme	 adj. 极度的，极端的
bungee jumping	 n. 蹦极
snowboarding	 n. 单板滑雪
snow rafting	 n. 动力雪橇滑降
in order to do something	 目的是，以便
gymnastics	 n. 体操，体操训练
similarity	 n. 相似性，类似性
upside down	 颠倒地，倒置地
exactly	 adv. 确切地，精确地；确实如此
risk	 vt. 冒……的危险；冒险做
excitement	 n. 兴奋，激动
various	 adj. 不同的，各种各样的
flow	 vi. 流动，涌出
equipment	 n. 配备，设备
dull	 adj. 枯燥无味的；暗淡的；迟钝的
preference	 n. 较喜欢的东西，偏爱
turn up	 出现，到场
back out	 决定不履行(允诺的事)
get across	 使理解(某事)
jog	 vi. 慢跑
traveller	 n. 旅行者，旅客
emperor	 n. 皇帝
court	 n. 宫廷；法庭
in turn	 轮流
amaze	 vt. 使惊愕(惊奇)
goods	 n. 商品，物品
confuse	 vt. 使困惑
fuel	 n. 燃料
wealthy	 adj. 富有的，富裕的
break out	 (坏事)突然发生，爆发
put...into prison	 把……关进监狱
author	 n. 作者
dictation	 n. 口述；听写
stand by	 坚持(某种说法)
statement	 n. 陈述
quantity	 n. 量，数量
professor	 n. 教授
hunter	 n. 猎人
skin	 n. 皮，皮肤
the Antarctic.	 南极地区
on one's way	 在途中
Norwegian	 adj. 挪威的 n. 挪威人
preparation	 n. 准备，预备
sledge	 n. 雪车，雪橇
break down	 损坏，不能运转
shock	 vt. 震惊，惊骇
goal	 n. 目的；目标
ambition	 n. 志向，抱负；野心
exhausted	 adj. 疲惫的
run out of	 用完，耗尽
hopeless	 adj. 没有希望的
cheerful	 adj. 愉快的，高兴的
distant	 adj. 远处的；久远的
carry on	 继续做某事
within	 prep. 在……之内，在……内部
sadness	 n. 悲哀，忧伤
function	 vi. 运转；发挥作用
patience	 n. 耐心；忍耐力
nationality	 n. 国籍
aim	 n. 目标；目的
Arctic	 n. 北极，北极区
transport	 n. 运输，运送
observe	 vt. 观察，观测
disadvantage	 n. 不利，不利条件
staff	 n. 员工，全体工作人员
survival	 n. 幸存，残存
shelter	 n. 遮蔽；庇护所
philosophy	 n. 哲学
limit	 n. 边界；限度
ferry	 n. 渡船
minibus	 n. 小巴
cyclist	 n. 骑自行车的人
motorist	 n. 驾驶汽车的人
pedestrian	 n. 行人
jam	 n. 阻塞，拥挤
traffic jam	 交通阻塞，塞车
actually	 adv. 实际地，真实地
benefit	 vi&n. 得益；好处
flat	 adj. 平的
therefore	 adv. 所以，因此
convenient	 adj. 方便的，便利的
parking	 n. 停车场
convenience	 n. 方便，便利
hopeful	 adj. (人)抱有希望的
neighbourhood	 n. 街坊；邻近地区
wherever	 adv. 无论在何处，无论到哪里
thief	 n. 贼，小偷
chip	 n. 集成电路片，硅片
insert	 vt. 插入，嵌入
indeed	 adv. 当然，确实
fed up	 不愉快的，厌烦的
consequence	 n. 后果，结果
arrest	 vt. 逮捕，拘留
bone	 n. 骨头
work out	 锻炼身体，做运动
argue	 vi. 争辩，争吵
baggage	 n. 行李
platform	 n. 站台，月台
belt	 n. 带子
ambassador	 n. 大使
sensitive	 adj. 善解人意的；敏感的
grey	 adj. 灰色的，灰白的
gentle	 adj. 和善的，温和的
fierce	 adj. 凶狠的，凶恶的
vocabulary	 n. 词汇；词汇量
interpreter	 n. 译员，口译者
schedule	 n. 时间表；进度表
timetable	 n. 时间表
foolish	 adj. 愚蠢的
responsibility	 n. 责任，负责，职责
rely on	 依赖，依靠
hostess	 n. 女主人
air hostess	 空中小姐
non-smoking	 adj. 禁止吸烟的
case	 n. 大箱子
suitcase	 n. 手提箱，皮箱
pull up	 (车辆)停止，停车
pull out	 (火车)驶离车站，出站
content	 n. 容纳的东西；目录
petrol	 n. 汽油
gas	 n. 气体；煤气；汽油
solar	 adj. 太阳的，太阳光的
racer	 n. 赛车手
sunlight	 n. 阳光，日光
kindergarten	 n. 幼儿园
so far	 迄今为止，到目前为止
take place	 举行；发生
northwest	 n. 西北，西北方
southeast	 n. 东南，东南方
chapter	 n. 章节
impression	 n. 印象，感觉
reliable	 adj. 可靠的
golf	 n. 高尔夫球(运动)
operator	 n. 操作人员，接线员
appreciate	 vt. 感谢；欣赏
essay	 n. 散文
shopping	 n. 购物
carbon monoxide	 一氧化碳
highway	 n. 公路
construction	 n. 建筑；建筑物
pavement	 n. 人行道
crossroads	 n. 十字路口
amount	 n. 数量
physical	 adj. 身体的；物质的
motor	 adj. 机动车辆的 n. 马达，发动机
figure	 n. 数字，数目
go up	 上升
engine	 n. 发动机，引擎
per	 prep. 每，每一
centigrade	 n. 摄氏(度)
admit	 vt. 承认，供认
addicted	 adj. 沉溺于……的
on average	 平均；通常
occupy	 vt. 占有(空间、面积、时间等)
somehow	 adv. 以某种方式
whichever	 pron. 无论哪个
suit	 vt. 适合
damage	 vt&n. 损害，损失
nowhere	 adv. 无处，任何地方都不
crossing	 n. 交叉路口，人行横道
tunnel	 n. 地道；隧道
plus	 prep. 加，加上
frequent	 adj. 时常发生的
fare	 n. 票价，车费
