access	 v. 获取 n. 接近，入口
project	 n. 工程；课题、作业
intention	 n. 打算，意图
equivalence	 n. 等值，相等
negotiate	 v. 谈判，协商，交涉
disappointing	 adj. 令人失望的
alternative	 n. 代替品
generous	 adj. 慷慨的
biological	 adj. 生物的
strategy	 n. 策略，战略
paradox	 n. 悖论；自相矛盾
primary	 adj. 主要的，基本的
standpoint	 n. 立场
grab	 v. 抢先，抢占，抢夺
crucial	 adj. 至关重要的
flaw	 n. 缺点；错误
depressed	 adj. 萧条的；沮丧的
obstacle	 n. 阻碍
automatic	 adj. 自动的
passionate	 adj. 热情的
gambling	 n. 赌博
logic	 n. 逻辑
theory	 n. 理论
download	 v. 下载
signal	 n. 信号 v. 发信号，打信号；示意
authoritative	 adj. 权威的
smooth	 adj. 光滑的
institution	 n. 社会公共机构；制度；设立，制定
vehicle	 n. 车辆
plague	 v. 使困扰
psychological	 adj. 心理上的
shade	 n. 阴凉处
persistent	 adj. 持续的；坚持的
voluntary	 adj. 自愿的，主动的
tolerance	 n. 宽容，容忍
senior	 n. 老年人
individual	 n. 个人
contemporary	 adj. 当代的，现代的
opposite	 adj. 相反的
specialize	 v. 专业从事
content	 n. 内容
philosopher	 n. 哲学家
unrest	 n. 不安定，动荡
startle	 v. 吃惊
emission	 n. 排放，辐射
overweight	 adj. 超重的
occupation	 n. 职业，工作
mainstream	 n. 主流
scholarship	 n. 奖学金
contract	 n. 合同
cheek	 n. 脸颊
interdependence	 n. 相互依靠
import	 n. 进口 v. 进口
fiction	 n. 小说，虚构的文学作品
upbringing	 n. 养育，培养，教养
preserve	 v. 保护
vitally	 adv. 极其重要地
masculine	 adj. 男性的
advocate	 v. 倡导 n. 提倡者，拥护者，鼓吹者
dust	 n. 灰尘
track	 n. 足迹 v. 追踪，〔循着踪迹、气味等〕找寻
confidence	 n. 信心
riotous	 adj. 狂暴的
sophisticated	 adj. 复杂的；世故的
similar	 adj. 相似的
transform	 v. 改变
approve	 v. 赞成，同意
session	 n. 开会，会议
awareness	 n. 意识
exhaust	 v. 使筋疲力尽
subsidize	 v. 提供补贴
grocery	 n. 杂货店
ignorance	 n. 无知，愚昧
intelligence	 n. 智力，智慧，理解力
tiny	 adj. 微小的
praise	 v. 赞扬，赞美
memorize	 v. 熟记，牢记
relative	 adj. 相对的 n. 亲戚
breakthrough	 n. 突破
incidence	 n. 几率，发生率
scratch	 n. 抓，划痕
harmful	 adj. 有害的
undergo	 v. 承受
recession	 n. 衰退
extraordinary	 adj. 非凡的
improper	 adj. 不合适的，不适当的
marginalize	 v. 边缘化，排斥
vital	 adj. 重要的
fortunately	 adv. 幸运地
commencement	 n. 毕业典礼
fetch	 v. 取回
clumsy	 adj. 笨拙的，不圆滑的
establishment	 n. 确立
emit	 v. 发出，排出
entertaining	 adj. 有趣的，使人愉快的
irregular	 adj. 不规律的
psychologist	 n. 心理学家
era	 n. 纪元，年代
triumph	 n. 胜利
detection	 n. 侦查；察觉
cozy	 adj. 舒适的
gallery	 n. 美术馆
enormous	 adj. 巨大的
obtain	 v. 获得
desert	 v. 抛弃
aviate	 v. 驾驶飞机
determine	 v. 决定；下决心
disappear	 v. 不见，消失
entitle	 v. 使具有权利，使具有资格
relieve	 v. 解除，减轻，缓解
generosity	 n. 慷慨，大方
colleague	 n. 同事
undertake	 v. 承担
convenient	 adj. 方便的
preferentially	 adv. 优先地
column	 n. 专栏
affectionate	 adj. 深情的，柔情的
issue	 v. 发表〔声明〕 n. 问题
inquire	 v. 询问
groundlessly	 adv. 无缘无故地，无根据地
independently	 adv. 独立地
approach	 v. 靠近 n. 方法
administration	 n. 管理；〔某一时期的〕政府
adversity	 n. 逆境，不幸
technician	 n. 技术员，技师
regular	 adj. 有规律的，经常的
miscalculation	 n. 算错，误算
hinder	 v. 阻碍
selection	 n. 选择，挑选
tide	 n. 潮水
superior	 adj. 上级的，较高的 n. 上级，长官
matter	 v. 要紧，重要
passively	 adv. 消极地
grant	 v. 授予；允许
liberation	 n. 解放
observe	 v. 遵守
institute	 v. 建立 n. 〔从事科研或教育等的〕机构；学院；研究院
dormitory	 n. 宿舍
awful	 adj. 可怕的，骇人的
emergency	 n. 紧急情况
stress	 n. 压力；重音
launch	 v. 发动
suppose	 v. 料想，以为；假定；期望
remove	 v. 消除，移除
exposure	 n. 暴露；揭露
promote	 v. 促进，提升；推销
engage	 v. 从事；吸引
uncertain	 adj. 不确定的
accommodate	 v. 为…提供住宿
slave	 n. 奴隶
mature	 adj. 成熟的
contrast	 n. 对照物 v. 对比
clinic	 n. 诊所
award	 v. 授予；判给 n. 奖(金)
worthwhile	 adj. 有价值的
cruelty	 n. 残暴，残酷
threaten	 v. 威胁
chemical	 adj. 化学的 n. 化学制品
consistent	 adj. 一致的
renew	 v. 〔中止后〕重新开始，继续
takeoff	 n. 起飞
innocent	 adj. 无辜的；天真的
currently	 adv. 当前；一般地
dropout	 n. 辍学者
replace	 v. 代替
sightseeing	 n. 观光
honor	 n. 荣誉；崇敬，敬重，敬意
imitate	 v. 模仿
installment	 n. 分期付款
personality	 n. 个性，性格
headquarter	 v. 设立总部，在…设立总部
ingredient	 n. 成分，原料
revenue	 n. 收入
sensitive	 adj. 敏感的
particular	 adj. 特别的，特指的；讲究的；挑剔的，吹毛求疵的
tumor	 n. 瘤
consequence	 n. 结果，成果
explicitly	 adv. 直接地，明确地
sway	 v. 影响
technical	 adj. 技术的
expert	 adj. 熟练的，内行的
harm	 n. 损害；危害；伤害 v. 伤害，损害〔某事物〕
imaginary	 adj. 虚构的，想象的
contaminate	 v. 污染，弄脏
soar	 v. 猛增
solely	 adv. 单独地，唯一地
tremendous	 adj. 巨大的
civilization	 n. 文明
tough	 adj. 困难的
gift	 n. 礼物；天赋
scale	 n. 规模；比例
injure	 v. 使受伤
embrace	 v. 拥抱；欣然接受，乐意采纳 (新思想、意见、宗教等)
seldom	 adv. 很少，罕见
performance	 n. 演出；履行；表现
violate	 v. 违反
associate	 v. 把……联系起来；交往；
privacy	 n. 隐私
choke	 v. 使窒息
capable	 adj. 能干的，有能力的
appeal	 n. 呼吁 v. 吸引；呼吁；恳请，恳求
careless	 adj. 粗心的
hit	 n. (唱片、电影或戏剧的) 成功；命中，击中
swallow	 v. 咽下，吞下
consult	 v. 咨询
preservation	 n. 保存，保留
distance	 n. 距离
plastic	 adj. 塑料的
predict	 v. 预言，预测，预告
submit	 v. 提交
entertainment	 n. 娱乐
critical	 adj. 批评的，爱挑剔的
transaction	 n. 交易，业务，事务
via	 prep. 通过
insist	 v. 主张，坚持
distract	 v. 分心
subdivision	 n. 分支; 分部
yield	 v. 产生，得出〔结果、答案或资料 n. 产量
misunderstand	 v. 误解
detail	 n. 细节
immeasurable	 adj. 无法估量的
convincing	 adj. 令人信服的
donate	 v. 捐赠
compare	 v. 比较，对照
item	 n. 〔尤指清单上、一群或一组事物中的〕一项，一件，一条
concrete	 adj. 具体的
govern	 v. 管理，支配
classify	 v. 把…分类，把…分级
restrict	 v. 限制，限定
establish	 v. 建立，创办，设立
counseling	 n. 咨询服务
majority	 n. 多数
contact	 n. 联系，接触 v. 〔写信、打电话〕联系〔某人〕
virtual	 adj. 虚拟的
simplicity	 n. 简单
enrollment	 n. 入学人数
programming	 n. 〔计算机的〕程序编写，程序设计；程序；；〔电视或广播〕节目；电视[广播]节目策划，编排
device	 n. 装置，设备
previous	 adj. 之前的
alter	 v. 改变
coach	 n. 教练 v. 当…的教练，训练，培训
crisis	 n. 危机
interconnect	 v. 相互联系
enrich	 v. 丰富；使富有
poll	 n. 民意调查
consent	 v. 允许，同意 n. 同意，赞同
utility	 n. 公用事业〔如煤气、电力等〕
poisonous	 adj. 有毒的，有害的
collision	 n. 冲突，抵触
rank	 v. 具有…等级[地位] n. 衔，阶层
fundamentally	 adv. 根本上
inflation	 n. 通货膨胀
secure	 v. 确保……安全
interpret	 v. 解释
criticize	 v. 批评；评论
arrest	 v. 逮捕
afford	 v. 负担得起
implementation	 n. 实现，履行
initiate	 v. 开始，发起
enable	 v. 使能够……
narrow	 adj. 狭窄的
overcharge	 v. 向……多收费
shortcut	 n. 捷径，近路
leisure	 n. 悠闲，空闲
original	 adj. 原始的，最初的
density	 n. 密度
sphere	 n. 球体；范围
margin	 n. 页边的空白，页边，白边
department	 n. 部门
desire	 n. 渴望，欲望
legend	 n. 传奇
dictator	 n. 独裁者；专制者
diversity	 n. 多样性；差异
quit	 v. 放弃
outgoing	 adj. 开朗的；外向的；外出的
solution	 n. 解决，解答，解决办法
revenge	 n. 报仇
reverse	 n. 相反情况；正相反 a. 相反的
enroll	 v. 注册
logically	 adv. 合乎情理地，符合逻辑地
rental	 n. 租金
component	 n. 成分
quotation	 n. 引文
faith	 n. 信任
invalid	 adj. 无效的
invade	 v. 侵入，侵略
separately	 adv. 分别地，另行
strain	 v. 扭伤，拉伤
accessible	 adj. 易接近的
lap	 n. 〔坐着时的〕大腿部
character	 n. 角色
widespread	 adj. 普遍的，广泛的
rearrange	 v. 重新安排
hospitalize	 v. 就医
avail	 v. 有益, 有帮助
instant	 adj. 立即的；紧急的；速溶的，方便的
democratic	 adj. 民主的
barely	 adv. 仅仅，几乎不
vanish	 v. 消失
caregiver	 n. 照料者
harsh	 adj. 严酷的
reliable	 adj. 可靠的，可信赖的
massive	 adj. (尺寸、数量、规模) 非常大的
alcohol	 n. 酒精
pregnant	 adj. 怀孕的
adapt	 v. 适应于
bogus	 adj. 假冒的
slippery	 adj. 滑的；模糊的，不明确的，
current	 adj. 当前的
overwhelm	 v. 压倒，战胜
stressful	 adj. 充满著压力的，充满著紧张的
toothache	 n. 牙痛，牙疼
eliminate	 v. 消除
terminal	 n. 终点站，航空站
severe	 adj. 严重的
immobile	 adj. 稳定的，不变的
diplomatic	 adj. 外交的
candidate	 n. 申请求职者；投考者；候选人
fund	 n. 基金，储备； v. 提供资金
complacency	 n. 自满，满足
delight	 n. 高兴
inadequate	 adj. 不足的，不够的
steady	 adj. 稳定的，逐步的
accurate	 adj. 精确的，准确的
identification	 n. 身份证明；鉴定，识别；认同；
previously	 adv. 事先
identical	 adj. 相同的
retirement	 n. 退休
commit	 v. 犯罪；承担义务
element	 n. 要素；元素
assess	 v. 评价
hire	 v. 雇佣
represent	 v. 代表
overestimate	 v. 对（数量）估计过高
supervision	 n. 监督
expose	 v. 暴露
seemingly	 adv. 表面上看
assignment	 n. 作业
preference	 n. 偏爱
energetic	 adj. 精力充沛的
application	 n. 申请；应用
moral	 adj. 精神上的, 道德的
dispute	 n. 辩论，争论 v. 辩论，争论
influence	 n. 影响 v. 影响
illegal	 adj. 非法的
esteem	 n. 自尊
abundant	 adj. 大量的，丰富的
survey	 v. 调查；审视，仔细考虑 n. 调查；勘测，测量，测绘
extensively	 adv. 广泛地
deserve	 v. 值得
crash	 v. 坠落;坠毁;撞击 n. 〔汽车的〕撞车事故；〔飞机的〕坠毁，失事
affirm	 v. 断言，声明
reputation	 n. 名气，名声，名誉
degree	 n. 程度
fade	 v. 逐渐消失
competitor	 n. 竞争者，对手
confuse	 v. 使混淆，迷惑
task	 n. 任务，工作
lessen	 v. 减少
admit	 v. 承认；容许
bow	 v. 鞠躬
division	 n. 除法；部门
literature	 n. 文学，文学作品；文献；文献
consultant	 n. 顾问
penalty	 n. 惩罚
comment	 n. 评论
major	 adj. 主要的 v. 主修
option	 n. 选择
socialize	 v. 交往，联谊
bureau	 n. 局
budget	 n. 预算 v. 编预算
pop	 v. 突然出现，跳出
position	 n. 职位
unaffordable	 adj. 买不起的，负担不起的
function	 n. 功能 v. 运行
perceive	 v. 察觉
reserve	 v. 留出，预定
innovation	 n. 改革，创新
alert	 v. 提醒；使〔某人〕意识到 adj. 机警的
cautious	 adj. 谨慎的
document	 n. 文件
characterize	 v. 以……特点
achieve	 v. 完成，实现
address	 v. 解决
inspiration	 n. 灵感
agency	 n. 机构
formulate	 v. 规定，制定
fate	 n. 命运
surf	 v. 冲浪
steer	 v. 驾驶
structure	 n. 结构
architect	 n. 建筑师
frame	 n. 框架
amaze	 v. 使吃惊
affirmation	 n. 断言，肯定
intelligent	 adj. 有智慧的，聪明的，悟性强的
code	 n. 代码，密码
burden	 n. 重担，负担
absorb	 v. 吸收（液体、气体等）
instruction	 n. 用法说明；操作指南；命令，指示
admission	 n. 承认；准许进(加)入；入场费
additional	 adj. 额外的
prejudice	 n. 偏见 v. 使有偏见，使有成见
process	 n. 过程，进程；；工序；工艺流程 v. 处理
elegant	 adj. 优雅的
hospitable	 adj. 热情友好的
refreshing	 adj. 恢复活力的
ensure	 v. 确保
frighten	 v. 使惊恐，使恐慌
civilized	 adj. 文明的
approval	 n. 批准，认可；赞成，同意
publicize	 v. 宣布
resident	 n. 居民
considerate	 adj. 体贴的；考虑周到的
twist	 v. 扭曲，使弯曲
citizen	 n. 市民，城镇居民；公民
stake	 n. 风险
keenly	 adv. 敏锐地
superficial	 adj. 肤浅的
flexibility	 n. 灵活性；适应性
favorable	 adj. 赞同的
competent	 adj. 胜任的，有能力的
emotional	 adj. 情绪(上)的，情感(上)的；激起感情的； 敏感的；情绪激动的〔尤指哭泣〕
pioneer	 v. 开拓，开发
sustain	 n. 维持
gloomy	 adj. 阴沉的，沮丧的
convince	 v. 使相信
profitable	 adj. 有利可图的，有益的
routinely	 adv. 例行公事地
phenomenon	 n. 现象
variety	 n. 多样
gum	 n. 牙龈
criticism	 n. 批评
fatal	 adj. 致命的，攸关的
delightful	 adj. 高兴的
tedious	 adj. 单调沉闷的
flexible	 adj. 灵活的
considerably	 adv. 相当地，非常地
efficiently	 adj. 有效地
appearance	 n. 外表, 外观；出现
album	 n. 粘贴簿，集邮簿，册
optimistic	 adj. 乐观的
clue	 n. 线索
grief	 n. 悲伤
synthetic	 adj. 合成的，人造的
resistance	 n. 抵御，抵抗；抵抗力
install	 v. 安装
pledge	 n. 保证，誓言
unique	 adj. 独特的，唯一的
stock	 n. 股票；库存
disadvantage	 n. 不利情况，缺点
compensate	 v. 弥补，补偿
rescue	 v. 营救，援救
monitor	 v. 监控；监听
refusal	 n. 拒绝
exile	 n. 流放，放逐
encourage	 v. 鼓励
concept	 n. 观点，观念
render	 v. 给予
trait	 n. 性格
feature	 n. 特点
reframe	 v. 再构造(图画、照片等)
identify	 v. 认出，识别；视为
impose	 v. 强加
snack	 n. 零食，小吃
require	 v. 要求，命令
donation	 n. 捐赠
equal	 adj. 相等的，平等的
rare	 adj. 罕有的，少见的
specify	 v. 指定，具体说明
constant	 adj. 不断的，持续的
standardize	 v. 使标准化
consume	 v. 消费，消耗
status	 n. 地位
complement	 v. 补充
lengthy	 adj. 长的，漫长的
embarrassed	 adj. 尴尬的；窘迫的
rational	 adj. 神智清楚的
distant	 adj. 遥远的
homemaker	 n. 主妇
exception	 n. 例外
sustainable	 adj. 可持续的
trigger	 v. 引发，引起
intend	 v. 打算
spread	 v. 扩散；传播
estimate	 v. 估计
technique	 n. 技巧，手艺；技术，技能
include	 v. 包含
academic	 adj. 学术的
distinctive	 adj. 独特的，与众不同的
consist	 v. 由……组成
bid	 n. 出价，投标 v. 出价，投标
benefit	 v. 有益于，有助于
downsize	 v. 裁员
avoid	 v. 避免
gender	 n. 性别
interracial	 adj. 种族间的
complaint	 n. 抱怨; 投诉
pattern	 n. 模式
mood	 n. 心情
sympathy	 n. 同情心
discount	 n. 折扣
value	 v. 重视
altitude	 n. 海拔, 高度
groundsheet	 n. 防潮布
evolutionary	 adj. 进化的；演变的
implement	 v. 实施，执行
dominant	 adj. 占优势的
scope	 n. 范围
suspect	 v. 怀疑，猜想 n. 嫌疑犯
confrontation	 n. 冲突，对抗
puzzle	 v. 迷惑 n. 难解之事，谜
critic	 n. 批评家，评论家
apartment	 n. 公寓
analyze	 v. 分析
maintain	 v. 维持；主张
curb	 v. 控制 n. 控制
version	 n. 版本
rival	 n. 对手
beneficial	 adj. 有利的，有益的
substantial	 adj. 大量的
recover	 v. 恢复；重新获得；寻回
diploma	 n. 文凭
carpenter	 n. 木匠
circumstance	 n. 环境，境遇
canteen	 n. 食堂
advocator	 n. 主张者，倡导者
disorderly	 adj. 杂乱的
essentially	 adv. 本质上，根本上
prevent	 v. 预防
ceremony	 n. 典礼，仪式
assume	 v. 假定，认为
demand	 n. 需求，要求 v. 要求
principle	 n. 原则，原理
reception	 n. 接待；反响
transfer	 v. 转换，调换 n. 转换，调换
preventable	 adj. 可预防的
anticipate	 v. 预感
assumption	 n. 假定，假设
prescription	 n. 处方
evolution	 n. 演变，进化
annoy	 v. 使反感，厌烦
unintended	 adj. 意想不到的
origin	 n. 起源
qualify	 v. 使……有资格
emergence	 n. 出现，发生
complain	 v. 抱怨
merit	 n. 优点，成绩 v. 值得
forum	 n. 论坛
arrange	 v. 安排，筹划
determination	 n. 意志
bargain	 n. 便宜货，减价品
appetite	 n. 欲望, 胃口
neutral	 adj. 中立的
primitive	 adj. 原始的；简单的；简单的，简陋的
therapy	 n. 疗法 治疗
conscience	 n. 良心
define	 v. 确定；下定义
creativity	 n. 创造力
tailor	 v. 调整使适应
dramatically	 adv. 戏剧性地，引人注目地
panic	 n. 惊恐
motivation	 n. 激励，刺激
durable	 adj. 持久的，耐用的
remedy	 n. 药物
inevitable	 adj. 不可避免的
diverse	 adj. 各种各样的
context	 n. 背景，环境
prominent	 adj. 杰出的；突出的，凸起的
witness	 n. 目击者，目击
save	 v. 节省
inherit	 v. 继承
occasion	 n. 场合
initiative	 n. 主动权，自主权
insight	 n. 洞察力，洞悉
misguided	 adj. 被误导的
sponsor	 v. 赞助
porter	 n. 搬运工
loyalty	 n. 忠诚，忠实
overwhelming	 adj. 压倒性的
appreciation	 n. 感激
setting	 n. 背景，环境
display	 n. 展览 v. 展览
deliver	 v. 发表
astonish	 v. 使惊讶，使大为吃惊
adequate	 adj. 足够的
consumption	 n. 消费，消耗
abuse	 v. 虐待；滥用
broad	 adj. 宽的
inappropriate	 adj. 不合适的
worldwide	 adv. 全世界范围地
strict	 adj. 严格的
means	 n. 方法
reveal	 v. 揭露，揭示
confirm	 v. 证实
consensus	 n. 一致意见
agent	 n. 代理商
neighborhood	 n. 地区
participate	 v. 参与，参加
valid	 adj. 有效的
initially	 adv. 最初，起初
slightly	 adv. 轻微地
objection	 n. 反对
atmosphere	 n. 气氛；大气；空气
assign	 v. 布置；分配
evidence	 n. 根据，证据，迹象
racially	 adv. 种族上地
exclude	 v. 排除，不包括
available	 adj. 可利用的，现有的；可获得的
puzzling	 adj. 令人困惑的
evaluation	 n. 评价，评估
irritate	 v. 激怒
distinguished	 adj. 显著的，杰出的
depressing	 adj. 令人沮丧的
mutually	 adv. 互相地
mission	 n. 使命，任务；代表团
migration	 n. 迁移，移民
site	 n. 场所，地址
expectation	 n. 期望
update	 v. 更新；使现代化
gear	 n. 齿轮 v. 使合适
reproductive	 adj. 生殖的，再生的
incredible	 adj. 不可思议的
backward	 adv. 向后
raise	 v. 提高；筹款；抚养
prohibit	 v. 禁止，阻止，防止
bother	 v. 麻烦；打扰
pose	 v. 摆姿势，装腔作势 n. 姿势
instrument	 n. 仪器，器械，工具
mask	 v. 掩饰
essential	 adj. 必须的；本质的
harvest	 n. 丰收，收获
reject	 v. 拒绝，驳回
advancement	 n. 进步，提升
skyrocket	 v. 突升，猛涨
characteristic	 n. 特点
implication	 n. 含义，暗示
measure	 n. 分量 v. 测量
replacement	 n. 代替
easygoing	 adj. 脾气随和的，温和的
squeeze	 v. 压，榨
exhibition	 n. 展览
responsibility	 n. 责任
enhance	 v. 提高；加强；增加
retain	 v. 保留,留用
convey	 v. 传达，传递
regulation	 n. 管理；规则
integrity	 n. 完整
combine	 v. 联合，结合
impermanency	 n. 非永久性
catalogue	 v. 把……编入目录
council	 n. 议会
prepare	 v. 做准备
inquiry	 n. 询问
tension	 n. 紧张
prompt	 adj. 迅速的；立刻的；及时的 v. 促使；激励
attendance	 n. 出席人数
retail	 n. 零售 v. 零售
image	 n. 形象，声誉，；印象
quantity	 n. 量，数量
inspector	 n. 检查员
endurance	 n. 耐力
simplify	 v. 简化
range	 n. 范围 v. 在范围内变化
accomplish	 v. 完成
treatment	 n. 治疗；对待
spare	 adj. 空闲的
welfare	 n. 幸福；福利
boost	 n. 推动 v. 促使，促进
consciousness	 n. 意识
patiently	 adv. 耐心地
decent	 adj. 正派的，体面的
review	 n. 回顾 v. 复习
considerable	 adj. 相当大(或多)的
misguide	 v. 误导
foundation	 n. 地基；基础；；基金会
postgraduate	 n. 研究生
prevail	 v. 流行，盛行
solid	 adj. 扎实的，坚实的
counsel	 v. 忠告，建议
maximum	 n. 最大值，最大量 a. 最大值的，最大量的
abstract	 adj. 抽象的
realistic	 adj. 现实的，实际的
ban	 v. 禁止
ashamed	 adj. 羞耻的；内疚的；惭愧的
solve	 v. 解决
reinforce	 v. 加强，强化
applicant	 n. 申请人
tuition	 n. 学费
persistence	 n. 坚持不懈
overcome	 v. 战胜，克服
bride	 n. 新娘
engagement	 n. 婚约
household	 n. 家庭，一家人
evaluate	 v. 评价
saint	 n. 圣人
delay	 v. 推迟，延期
private	 adj. 私人的
definition	 n. 定义
influential	 adj. 有影响力的
recommend	 v. 推荐；劝告；使受欢迎
frontier	 n. 边境
concern	 n. 重要的事情 v. 与…有关，关于
organ	 n. 器官
cite	 v. 引用
mechanism	 n. 机制，机能
contest	 n. 比赛
symptom	 n. 症状
deadline	 n. 最后期限
domination	 n. 主导
figure	 n. 人物；数字
imply	 v. 暗示；意味；
curiosity	 n. 好奇心
induce	 v. 引诱
acknowledge	 v. 承认(…的权威)
gym	 n. 体育馆，健身房
chef	 n. 厨师
sensible	 adj. 明智的
outline	 n. 梗概，提纲，草稿，要点
react	 v. 对……作出反应
committee	 n. 委员会
civilian	 n. 平民，百姓
domestic	 adj. 国内的
complex	 adj. 复杂的
locate	 v. 位于，定位
tighten	 v. 使变紧
physics	 n. 物理，物理学
foothold	 n. 立足处（攀登时脚踩的地方）
discharge	 v. 释放；排出；批准离开; 命令离开
advanced	 adj. 高级的
complicated	 adj. 复杂的，难懂的
needy	 adj. 贫穷的
stale	 adj. 乏味的，没有新意的
casual	 adj. 漫不经心的，随便的；偶然的
conform	 v. 相一致，遵守
recharge	 v. 再充电
annually	 adv. 每年，一年一次
frown	 v. 皱眉
decline	 v. 下降，减少；拒绝
originate	 v. 开始
prospect	 n. 前景；前途
curious	 adj. 好奇的
incentive	 n. 动机，刺激
virus	 n. 病毒
cultivate	 v. 培养， 养成
potential	 n. 潜力 adj. 有可能的；潜在的
reluctant	 adj. 不愿意的，勉强的
miserable	 adj. 痛苦的
persuasion	 n. 劝说
competitiveness	 n. 竞争力
restriction	 n. 限制，限定
minor	 adj. 小的
grain	 n. 谷物，粮食
rate	 n. 比率，速率
radically	 adv. 完全地，彻底地
distinct	 adj. 明显的；有区别的
equality	 n. 平等
hardworking	 adj. 苦干的，不辞辛劳的
qualification	 n. 资格(证明)，合格证书
bacteria	 n. 细菌
corporate	 adj. 团体的；法人的
undermine	 v. 逐渐削弱; 逐渐动摇
selfish	 adj. 自私的
cater	 v. 迎合
survival	 n. 幸存
favor	 v. 偏好, 较喜欢
conflict	 v. 冲突
client	 n. 客户
garage	 n. 车库
fatigue	 n. 疲劳，疲乏
plant	 n. 工厂
endanger	 v. 危及，危害，濒临危险
operation	 n. 手术；行动
handle	 v. 处理
laborious	 adj. 费力的
passion	 n. 热情，激情
cooperative	 adj. 合作的
inflate	 v. (使)膨胀
resourceful	 adj. 机智的
exaggerate	 v. 夸张
loan	 n. 贷款
vocabulary	 n. 词汇
illustrate	 v. 说明,阐明
overflow	 v. 溢出，淹没
fantasize	 v. 想象，幻想
amusing	 adj. 有趣的，好玩儿的
universal	 adj. 宇宙的，全世界的；普遍的
generate	 v. 产生
schedule	 n. 日程表
backslide	 v. 倒退，退步
particle	 n. 微粒
menu	 n. 菜单
reward	 n. 报答，奖赏 v. 报答，奖赏
reproduce	 v. 复制
worsen	 v. （使）变得更坏
feedback	 n. 反馈
equivalent	 adj. 相等的，相当的
resign	 v. 辞职
motivate	 v. 促动，激发，诱导
compel	 v. 强迫
revise	 v. 修订
dampen	 v. 抑制
prosperity	 n. 繁荣
flow	 n. 流动 v. 流动
humanity	 n. 人类〔总称〕；人性
sideways	 adv. 向侧面
pursue	 v. 追求
innovate	 v. 创新，革新
mill	 n. 工厂
promotional	 adj. 促销的
dump	 v. 扔下，倾倒；倾销
resist	 v. 抵抗，抗拒
source	 n. 来源
legal	 adj. 法律的
picky	 adj. 挑剔的
steal	 v. 偷窃
despite	 prep. 尽管
explosion	 n. 爆炸
gap	 n. 缝隙，缺口；差距
relevant	 adj. 有关的，切题的
ignore	 v. 忽视，不顾
complete	 v. 完成 adj. 完整的，彻底的
sufficient	 adj. 足够的
switch	 v. 转变，改变
request	 n. 要求
stereotype	 n. 老套，固定模式
couple	 n. 夫妻，情侣
honesty	 n. 诚实
transportation	 n. 运输
physical	 adj. 身体上的
screen	 v. 筛查
divine	 adj. 神圣的
guideline	 n. 指导原则
revolution	 n. 革命
interruption	 n. 打扰；中断
dishwasher	 n. 洗碗机
promising	 adj. 有希望的，有前途的
vary	 v. 不同；变化
permanent	 adj. 永久的
manufacture	 v. 制造，生产
fussy	 adj. 爱挑剔的；
dictate	 v. 命令，规定 n. 命令，规定
professional	 adj. 专业的
prosper	 v. 繁荣
exchange	 n. 交换，交流 v. 交换，交流
concentration	 n. 集中
gesture	 n. 手势，姿势
deliberate	 adj. 故意的
contribution	 n. 贡献；捐款
bless	 v. 保佑，祝福
detective	 n. 侦探
evident	 adj. 明显的
retreat	 v. 退避，后退；撤退
responsible	 adj. 负责的，有责任的
identity	 n. 身份
statistics	 n. 统计学；数据
appreciate	 v. 感激；欣赏
insult	 v. 侮辱
neglect	 v. 疏忽；忽视
primarily	 adv. 主要地，首先
long	 v. 渴望
incline	 v. 倾向于
asset	 n. 有价值的人(或物)资产
overtake	 v. 超车
extension	 n. 分机
engine	 n. 引擎，发动机
emphasize	 v. 强调
genuine	 adj. 真正的
fascination	 n. 魅力；入迷
lodge	 v. 住宿，暂住
cheat	 v. 欺骗, 作弊
security	 n. 安全，安保
painful	 adj. 痛苦的，疼痛的，令人不快的
emerge	 v. 出现
instance	 n. 情况，例子
steep	 adj. 陡峭的；急剧升/降的
rigorous	 adj. 严格的
persuade	 v. 说服
procedure	 n. 程序
signature	 n. 签名
surpass	 v. 超过
campaign	 n. 活动
advance	 n. 提前 v. 前进
charity	 n. 慈善机构
average	 adj. 平常的
indispensable	 adj. 必不可少的
irrationally	 adv. 不合理地，无理性地
accompany	 v. 陪伴
aviation	 n. 航空
distress	 v. 使痛苦，悲痛
invariably	 adv. 不变地，一直
invest	 v. 投资
approximately	 adv. 大约
conservation	 n. 保护，保存
ease	 n. 轻松，舒适
extracurricular	 adj. 课外的
undoubtedly	 adv. 无疑
excellent	 adj. 卓越的，杰出的，极好的
investigate	 v. 调查
judgement	 n. 判断，决定
struggle	 v. 搏斗
prohibitively	 adv. 过分地，非常地
military	 adj. 军队的，军事的
consequently	 adv. 结果
suffer	 v. 受苦；遭受（痛苦）
visible	 adj. 看得见的
swift	 adj. 迅速的
battle	 n. 战争，战役
liability	 n. 责任
resistant	 adj. 抵抗的；抵制的
nutritious	 adj. 营养的
constantly	 adv. 不断地，时常地
familiar	 adj. 熟悉的
terribly	 adv. 可怕地，非常
restore	 v. 修复
refine	 v. 改善；精炼
inspire	 v. 激发；鼓舞；使产生灵感
comply	 v. 遵从
justice	 n. 公正
district	 n. 区
installation	 n. 安装；就职；就职仪式
marvelous	 adj. 引起惊异的
provoke	 v. 激起，挑起
lobby	 n. 大堂 v. 游说
interview	 n. 面谈（试）；会见； v. 采访 ；面试
release	 v. 释放；发布
explore	 v. 探索
profound	 adj. 深厚的
exploit	 v. 开采
startup	 n. 启动，开办
constructive	 adj. 建设的，建设性的
unbearable	 adj. 无法忍受的
laundry	 n. 要洗的衣服；刚洗过的衣物；洗衣房
seize	 v. 抓住
poison	 v. 使中毒
bakery	 n. 面包店
tent	 n. 帐篷
wedding	 n. 婚礼
fair	 n. 集市
geographic	 adj. 地理的
comprehensive	 adj. 综合的，全面的
riot	 n. 暴乱
conspicuous	 adj. 显著地
block	 v. 阻碍 n. 街区
acute	 adj. 敏锐的
endure	 v. 忍耐；容忍
assembly	 n. 装配
opponent	 n. 对手
confront	 v. 面对
stir	 v. 搅动；煽动，激起
rocket	 n. 火箭 v. 猛增
attribute	 v. 归因于
sentence	 n. 判决 v. 判决
tempting	 adj. 诱人的，吸引人的
commitment	 n. 承诺，保证
feasible	 adj. 可行的；可能的；可用的
outcome	 n. 结果
diligent	 adj. 勤奋的
deprive	 v. 剥夺，夺去，使丧失
grid	 n. 输电网
distribute	 v. 分发
destruction	 n. 破坏
divide	 v. 分开
highlight	 v. 突出；强调 n. 突出的部分
justify	 v. 证明……正当
announce	 v. 宣布，声称
proposal	 n. 提议
advisory	 n. 报告，警告
mystery	 n. 迷，神秘的事物
punctual	 adj. 准时的
derive	 v. 得到，导出
harmony	 n. 和谐
unwilling	 adj. 不愿意的
view	 v. 看待
financial	 adj. 财政的，经济的
priority	 n. 优先，优先权
impermanent	 adj. 非永久（性）的；不持久的，暂时的
symbolize	 v. 象征
bankrupt	 adj. 破产的，倒闭的
intake	 n. 摄入
addiction	 n. 上瘾
productive	 adj. 富有成效的
admire	 v. 钦佩，称赞
reflect	 v. 反映
underline	 v. 强调
representative	 n. 代表
blame	 v. 指责，责怪
retrain	 v. 再教育；再训练
tasteless	 adj. 无味的
excessive	 adj. 过度的
dishonest	 adj. 不诚实的
caution	 n. 小心，谨慎 v. 警告，告诫
glorious	 adj. 辉煌的
pointless	 adj. 无意义的
significant	 adj. 重要的
mutual	 adj. 相互的
temptation	 n. 诱惑，引诱
passive	 adj. 被动的
evolve	 v. 使发展
treasure	 v. 珍爱
shock	 v. 感到震惊
disservice	 n. 伤害，帮倒忙
ambitious	 adj. 有雄心的，野心勃勃的
fancy	 adj. 华丽的；别致的
accumulate	 v. 积累，增加
fuss	 n. 大惊小怪
ultimately	 adv. 最后，最终
showmanship	 n. 主持演出的技巧
cancel	 v. 取消
regulate	 v. 管理
peer	 n. 同龄人
calculate	 v. 计算
virtually	 adv. 几乎，差不多
accustom	 v. 使习惯
retailer	 n. 零售商
programmer	 n. 程序设计员
advice	 n. 建议
admiration	 n. 钦佩，称赞
courageous	 adj. 有勇气的
respectful	 adj. 有礼貌的，尊重的
makeup	 n. 化妆品
reservation	 n. 预定
apply	 v. 申请；应用
demonstrate	 v. 证明；展示
generation	 n. 一代人；产生
chat	 v. 聊天
ancient	 adj. 古代的
evil	 n. 邪恶，罪恶
indifferent	 adj. 冷漠的
namely	 adv. 即，也就是
effect	 n. 影响
devote	 v. 奉献，致力于
appointment	 n. 约会
appoint	 v. 任命，委派；约定，确定，指定
resemble	 v. 像，相似
assemble	 v. 集合；组装；集合
expressiveness	 n. 表达
visibility	 n. 能见度
distracted	 adj. 分心的
debt	 n. 债务
substitute	 n. 代替者 v. 代替
insecure	 adj. 不安全的
chap	 n. 小伙子，小家伙，家伙
selective	 adj. 选择的,精选的
compensation	 n. 弥补，补偿
dilemma	 n. 困境
foreseeable	 adj. 可以预见的
inadequacy	 n. 不足
guarantee	 v. 担保 n. 保证，担保
discrimination	 n. 歧视
intense	 adj. 强烈的
facilitate	 v. 使便利，促进
mislead	 v. 误导
reassess	 v. 重新评估
response	 n. 反应
essay	 n. 散文，文章
stimulate	 v. 刺激
dessert	 n. 甜点
peaceful	 adj. 平静的；和平的
regularly	 adv. 定期地，有规律地
fascinate	 v. 强烈地吸引，迷住
durability	 n. 持久
discover	 v. 发现
constitute	 v. 组成
administrative	 adj. 管理的
tremble	 v. 颤抖
ignorant	 adj. 无知的
decorate	 v. 装饰
acquire	 v. 获得
annual	 adj. 每年的
due	 adj. 到期的
situation	 n. 情况
archive	 n. 档案馆，档案室；档案
incomparable	 adj. 无比的，无可匹敌的
perspective	 n. 视角，观点；远景
compete	 v. 竞争
joint	 adj. 联合的
overload	 n. 负担太重
mechanic	 n. 机械师
distinguish	 v. 区别，区分
vote	 v. 投票，选举
everlasting	 adj. 永恒的
construction	 n. 建筑
aggressive	 adj. 挑衅的，好斗的；有上进心的
classification	 n. 分类，级别
melt	 v. 融化
detect	 v. 觉察；检测
discourage	 v. 阻止；使气馁
combination	 n. 联合，结合
grave	 n. 坟墓
malfunction	 n. 失灵，故障
reduce	 v. 减少
respectively	 adv. 各自地
forefinger	 n. 食指
wise	 adj. 聪明的，有智慧的
background	 n. 背景
symbol	 n. 象征，标志
quality	 n. 品质
repave	 v. 再铺，重新铺砌
downfall	 n. （雨等的）大下特下
ring	 n. 拳击台
planet	 n. 行星
pension	 n. 养老金
perception	 n. 感知
facility	 n. 设施
proportion	 n. 比例，部分
involve	 v. 卷入，包含
attempt	 n. 尝试，试图 v. 尝试，试图
conventional	 adj. 传统的
detailed	 adj. 细节的，详细的
interpretation	 n. 阐释，说明
guilt	 n. 有罪，犯罪行为
connectivity	 n. 连接，联系
behave	 v. 表现
instruct	 v. 指导；教授；通知；命令；
infinite	 adj. 无限的
hazard	 n. 危险
undervalue	 v. 低估
specific	 adj. 特定的，具体的
appealing	 adj. 吸引人的
fitness	 n. 健康
conclusion	 n. 结论
absent	 adj. 缺席的
antique	 n. 古玩，古董
myth	 n. 神话
intervention	 n. 干涉
trace	 n. 痕迹
protest	 v. 抗议
refuel	 v. （给）加油，加燃料
tackle	 v. 处理
finance	 n. 财政 v. 资助
fine	 v. 罚款
indicate	 v. 表明
dissatisfy	 v. 不满意
expand	 v. 扩大
spontaneous	 adj. 自发的
offense	 n. 犯罪；冒犯
abruptly	 adv. 突然地
recycle	 v. 循环，再利用
rude	 adj. 粗鲁的
contribute	 v. 捐款，贡献
embarrass	 v. 尴尬
weaken	 v. 减少，减弱
mineral	 n. 矿物
sticky	 adj. 粘的
challenge	 n. 挑战 . v. 质疑
excess	 n. 过量，过度
recruit	 v. 招募，吸收 n. 新兵，新成员
overstate	 v. 夸张，夸大
generalization	 n. 概括
hub	 n. 中心
conservative	 adj. 保守的，传统的
restock	 v. 重新进货，再储存
convict	 v. 证明…有罪
deepen	 v. 使加深，加剧
tank	 n. 油箱，水箱
negative	 adj. 消积的；否定的
accelerate	 v. 加速
territory	 n. 领土，领域
impact	 n. 影响
distraction	 n. 分心；消遣
resolve	 v. 解决；下决心
