abandonment	 n. 放弃
abnormally	 adv. 不正常的
absolutely	 adv. 当然
abstract	 adj. 抽象的
abuse	 n. 虐待 v. 滥用
accelerate	 v. 加速
accomplish	 v. 实现
accountant	 n. 会计
accrue	 v. 积累
accurate	 adj. 精确的
accuse	 v. 指控
accustom	 v. 使习惯
achieve	 v. 达到，实现
acquaintance	 n. 熟人
activate	 v. 激活
acutely	 adv. 敏锐地
addict	 v. 上瘾，沉溺
address	 v. 解决
administration	 n. 管理，政府
adopt	 v. 采纳
adventure	 n. 冒险
adventurer	 n. 冒险者
adverse	 adj. 相反的，敌对的
adversely	 adv. 不利地
affection	 n. 喜爱
agenda	 n. 议程
aggravate	 v. 加重，加剧
agonize	 v. 使痛苦
aid	 v. 援助，有助于
alert	 adj. 机警的 v. 提醒
alien	 adj. 陌生的
allergic	 adj. 过敏的
alternative	 n. 代替品
analytical	 adj. 分析的
ancient	 adj. 古代的
ankle	 n. 脚踝
anonymous	 adj. 匿名的
anticipate	 v. 期望，预期
anxiety	 n. 焦虑
apartment	 n. 公寓
apathy	 n. 冷漠
apologize	 v. 道歉
applicable	 adj. 可应用的
applicant	 n. 申请者
appoint	 v. 任命
appreciative	 adj. 表示赞赏的，感谢的
approach	 n. 方法
appropriate	 adj. 适当的
approve	 v. 赞同
approximately	 adv. 大约
arm	 v. 装备，武装
arouse	 v. 唤起
arrogant	 adj. 傲慢无礼的
artificial	 adj. 人造的，虚伪的
aspect	 n. 方面
assassinate	 v. 刺杀，暗杀
assemble	 v. 收集，组装
assessment	 n. 评估，评价
association	 n. 联系
athletic	 adj. 运动的，运动员的
atmosphere	 n. 气氛，空气
attendant	 n. 服务人员
authorities	 n. 当局
authority	 n. 权威
authorization	 n. 授权
automatic	 adj. 自动的
auxiliary	 adj. 辅助的
available	 adj. 可获得的，可利用的
awareness	 n. 意识
awesome	 adj. 极好的，令人敬畏的
backup	 n. 后补，援助
bacteria	 n. 细菌
ballet	 n. 芭蕾
barely	 adv. 几乎不，仅仅
barrier	 n. 障碍，阻碍
battery	 n. 电池
battle	 n. 激战，战役
bias	 n. 偏见
biography	 n. 自传
bitter	 adj. 痛苦的
bizarre	 adj. 古怪的；奇怪的
blame	 v. 谴责
blouse	 n. 衬衫
blueprint	 n. 蓝图，设计图
board	 n. 董事会
boom	 n. 繁荣
boost	 v. 提高
botanical	 adj. 植物学的
bother	 v. 困扰
branch	 n. 分支，分公司
breakthrough	 n. 突破性进展
breed	 v. 繁殖；导致
breezy	 adj. 轻松愉快的
bribe	 v. 贿赂
bridge	 v. 缩小；架桥于…之上
bruise	 v. 使碰伤，擦伤
brutal	 adj. 残酷的
buck	 v. 反对 n. 美元
burden	 n. 负担
bureaucracy	 n. 官僚主义
burial	 n. 埋葬
calculation	 n. 计算
calorie	 n. 卡路里
campaign	 n. 活动
cancel	 v. 取消
capable	 adj. 有能力的
capacity	 n. 能力，容量
capital	 adj. 资金的，资本的
capture	 v. 捕捉
cast	 v. 投掷，扔
casualty	 n. 伤亡人数
category	 n. 种类
cautious	 adj. 谨慎的
chain	 n. 连锁店
chaos	 n. 混乱
character	 n. 角色
check	 v. 检查；阻止
chronicle	 v. 记录
circulation	 n. 发行量
circumstance	 n. 情况，环境
citation	 n. 引文
claim	 v. 索取，声称
clarify	 v. 澄清，明确
classify	 v. 分类
clause	 n. 条款
clue	 n. 线索
coastal	 adj. 海滨的
code	 n. 代号，密码
collaborative	 adj. 合作的
collapse	 v. 坍塌，崩塌
collective	 adj. 共同的
collide	 v. 撞击，碰撞
commerce	 n. 商业
commitment	 n. 承诺
commodity	 n. 商品
compartment	 n. 车厢, 隔间
compel	 v. 强迫
compelling	 adj. 引人注目的
compensate	 v. 弥补
competence	 n. 能力
complaint	 n. 抱怨，投诉
complicated	 adj. 复杂的
comprehensive	 adj. 综合的，全面的
concession	 n. 妥协
conclusive	 adj. 得出结论的
concrete	 adj. 具体的
conduct	 v. 引导，管理
confine	 v. 限制
conflict	 n. 冲突
conformity	 n. 一致
confrontational	 adj. 对抗的，有敌意的
consensus	 n. 共识，一致
conservation	 n. 保护
conservative	 adj. 保守的
considerable	 adj. 相当多的
console	 v. 安慰
constant	 adj. 不断的
construction	 n. 建筑
consultancy	 n. 咨询
consumption	 n. 消费, 消耗
contamination	 n. 污染
content	 adj. 满意的
contention	 n. 争论
contrary	 adj. 相反的
contribute	 v. 有助于
contribution	 n. 贡献
controversy	 n. 争议
conventional	 adj. 传统的
convert	 v. 转换，改变
convict	 v. 证明……有罪
convince	 v. 使……相信
coordination	 n. 协调
corruption	 n. 腐败
counsel	 v. 建议，忠告
counselor	 n. 咨询顾问
countermeasure	 n. 对策
cover	 v. 报道
coverage	 n. 报道
criminal	 adj. 犯罪的 n. 罪犯
criteria	 n. 标准
critical	 adj. 挑剔的，批评的；关键的
criticism	 n. 批评
crucial	 adj. 关键的
curb	 v. 限制，控制
currency	 n. 货币
dare	 v. 勇敢，敢于做
debris	 n. 残骸，碎片
decent	 adj. 体面的
decisive	 adj. 决定性的
decline	 v. 拒绝
deem	 v. 认为
defect	 n. 缺点
defensive	 adj. 防守的，防御的
deficient	 adj. 不足的，缺乏的
deficit	 n. 赤字
defy	 v. 违背，违抗
deliberate	 adj. 故意的
delicate	 adj. 精细的，细微的
deliver	 v. 发表，递送
democracy	 n. 民主
denationalize	 v. 使非国有化
deny	 v. 否认
deprive	 v. 剥夺
derail	 v. 脱轨
derive	 v. 获得
descendant	 n. 子孙后代
descriptive	 adj. 描写的，描述的
deserve	 v. 值得
desperate	 adj. 绝望的，不顾一切的
destination	 n. 目的地
destructive	 adj. 破坏性的，毁灭性的
detached	 adj. 冷漠的，超然的
detect	 v. 发现
detective	 n. 侦探
diligence	 n. 勤奋
dim	 adj. 暗淡的；愚蠢的
diminish	 v. 减少
disadvantage	 n. 缺点，不利条件
disappear	 v. 消失
disarm	 v. 解除，消除
discipline	 n. 学科
disconnect	 v. 断开
discourage	 v. 阻止；使气馁
disengagement	 n. 分离，疏离感
dishonest	 adj. 不诚实的
dismiss	 v. 忽视
dispatch	 v. 发送，派遣
disproportionately	 adv. 比例不均地，不成比例地
disservice	 n. 帮倒忙，危害
distinctive	 adj. 与众不同的
distort	 v. 扭曲
distribution	 n. 分布，分配
diverse	 adj. 各种各样的
diversion	 n. 转移；娱乐
diversity	 n. 多样性
divert	 v. 转移
dividend	 n. 分红，红利
documentary	 n. 纪录片
dolphin	 n. 海豚
domestic	 adj. 国内的
dominate	 v. 主导，主宰
donor	 n. 捐赠者
dorm	 n. 宿舍
dramatically	 adv. 大幅度地；戏剧性地
drastically	 adv. 激烈地，猛烈地
drift	 v. 漂流
dropout	 n. 辍学
drought	 n. 干旱
drown	 v. 溺水
dweller	 n. 居住者
dysfunction	 n. 失灵
eccentric	 adj. 古怪的
ecological	 adj. 生态学的
edit	 v. 剪辑，编辑
election	 n. 选举
eliminate	 v. 消除
elite	 n. 精英
eloquent	 adj. 口才好的，雄辩的
emerge	 v. 出现
emphasize	 v. 强调
encounter	 v. 遭遇
encourage	 v. 鼓励
endless	 adj. 无限的，没完没了的
enforce	 v. 强迫，迫使
engage	 v. 忙于，从事；雇佣
enormous	 adj. 巨大的
enrich	 v. 丰富，使富裕
enrollment	 n. 入学人数
enthusiastic	 adj. 热情的
entrepreneurship	 n. 企业管理
epidemic	 n. 流行病
eradicate	 v. 根除
erect	 v. 建立
erroneous	 adj. 错误的
erupt	 v. 喷出, 爆发
essential	 adj. 本质的，必须的
esteem	 v. 尊重
ethnic	 adj. 种族的
evolution	 n. 演变；进化；发展
exaggerate	 v. 夸张
exceed	 v. 超过
exceptional	 adj. 例外的
excess	 n. 过量，过度
excessive	 adj. 过度的
executive	 n. 执行官
exert	 v. 施加
exotic	 adj. 异域的，外国的
expansion	 n. 扩大
expectation	 n. 期望
expedition	 n. 探险，远征
expenditure	 n. 费用，花销
expertise	 n. 专业知识
extend	 v. 延伸；延期
extent	 n. 程度
extinction	 n. 灭绝
extreme	 adj. 极端的
eyewitness	 n. 目击者
facility	 n. 设施
faculty	 n. 教工，教员
fade	 v. 褪色
fatal	 adj. 致命的
fatigue	 n. 疲惫
favor	 v. 偏爱
fearlessly	 adv. 无畏地，大胆地
fierce	 adj. 激烈的
figure	 n. 数字
fiscal	 adj. 财政的
flat	 adj. 平的 n. 公寓
flavor	 n. 口味
flaw	 n. 缺点，瑕疵
flee	 v. 离开
flexible	 adj. 灵活的
float	 v. 漂浮
footnote	 n. 注脚
forecast	 n. 预报，预测
format	 n. 形式
formidable	 adj. 可怕的；令人敬畏的，令人惊叹的
foster	 v. 促进；培养
foundation	 n. 基金会
frankly	 adv. 坦率地
frantic	 adj. 疯狂的
fresh	 adj. 新颖的，新奇的
frighten	 v. 使害怕
frontier	 n. 边境
frustrate	 v. 使挫败，使沮丧
fulfill	 v. 实现
furious	 adj. 生气的；激烈的
fuss	 n. 小题大做
gallery	 n. 美术馆
gap	 n. 差距
garage	 n. 车库
gender	 n. 性别
generate	 v. 产生
generous	 adj. 慷慨的
genetic	 adj. 基因的
genius	 n. 天才
genuine	 adj. 真的；由衷的
geology	 n. 地质学
gesture	 n. 姿势，手势
glamorous	 adj. 有魅力的，迷人的
glory	 n. 光荣，荣誉
govern	 v. 管理
grand	 adj. 壮丽的，极好的
grasp	 v. 抓住，理解
gratitude	 n. 感激
grocery	 n. 杂货店
guarantee	 v. 保证
guard	 v. 保护
guesstimate	 n. 大概估计，瞎猜估计
habitual	 adj. 习惯的
handgun	 n. 手枪
handle	 n. 把手
hardship	 n. 艰难
harsh	 adj. 严酷的，严峻的
hatch	 v. 孵化
hazard	 n. 危险
hesitate	 v. 犹豫
hinder	 v. 阻碍
hospitality	 n. 友好
host	 v. 主持
hostile	 adj. 有敌意的
household	 n. 家庭，一家人
humanistic	 adj. 人文的
humorous	 adj. 幽默的
hypothesis	 n. 假设，假说
identify	 v. 认出，识别
ideologically	 adv. 意识形态上地
ideology	 n. 意识形态
ignore	 v. 忽视
imbalance	 n. 不平衡
immense	 adj. 巨大的
immensely	 adv. 非常，极大地
immigrant	 n. 移民
imminent	 adj. 即将来临的
impact	 n. 影响
impose	 v. 强加于
imprison	 v. 监禁
inadequate	 adj. 不足的
incentive	 n. 刺激
incidence	 n. 发生率
incompetence	 n. 无能
index	 n. 指数
indicate	 v. 表明
indicative	 adj. 指示的
indifferent	 adj. 冷漠的
indiscriminately	 adv. 不加选择地，不加区分地
indispensable	 adj. 必不可少的
indulge	 v. 放纵
industrious	 adj. 勤奋的
ineffective	 adj. 无效的
inevitable	 adj. 不可避免的
inexhaustible	 adj. 用不完的，无穷无尽的
infant	 n. 婴儿
infect	 v. 感染
inflation	 n. 通货膨胀
influential	 adj. 有影响力的
inhale	 v. 吸入
inherit	 v. 继承
initiative	 n. 主动性
injustice	 n. 不公正
innovation	 n. 创新，革新
inspire	 v. 鼓励
instant	 adj. 立即的
instinctively	 adv. 本能地
institution	 n. 机构
insufficient	 adj. 不足的
integrity	 n. 正直
intelligent	 adj. 聪明的
intensely	 adv. 强烈地
interact	 v. 互动
interaction	 n. 互动
interference	 n. 干涉
interpretation	 n. 解释，理解
interracial	 adj. 种族间的
intervene	 v. 干涉
intervention	 n. 干涉
intriguing	 adj. 有趣的
invasion	 n. 入侵
irony	 n. 讽刺
irrelevant	 adj. 无关的
irritate	 v. 激怒
isolation	 n. 隔绝，隔离
judicial	 adj. 司法的
jury	 n. 陪审团
justifiable	 adj. 理所应当的
justified	 adj. 正当的
keen	 adj. 浓厚的；敏锐的
kidnap	 v. 绑架
lack	 v. 缺少
lag	 v. 落后
launch	 v. 发布，推出
lawn	 n. 草坪
layman	 n. 门外汉
layout	 n. 陈列
legend	 n. 传奇
legislation	 n. 立法
legislator	 n. 立法者
lest	 conj. 以免
lobby	 n. 游说
luxurious	 adj. 奢侈的，豪华的
magnify	 v. 放大
maintenance	 n. 维修
majority	 n. 大多数
mall	 n. 商场
manifest	 v. 表明
manufacture	 v. 生产，制造
marine	 adj. 海洋的
markedly	 adv. 显著地
mask	 n. 面具 v. 掩饰 掩盖
material	 n. 材料
materialize	 v. 实现
matter	 v. 重要；要紧
maturity	 n. 成熟
measure	 n. 措施
mechanism	 n. 机制
melt	 v. 融化
memo	 n. 备忘录
memorable	 adj. 值得纪念的
mention	 v. 提及
merit	 v. 值得 n. 优点
migrate	 v. 移民，迁徙
milestone	 n. 里程碑
minimal	 adj. 最低的，最小限度的
mining	 n. 矿产
minor	 adj. 次要的，小的
minority	 n. 少数，少数民族
miracle	 n. 奇迹
misfortune	 n. 不幸地
misinterpret	 v. 误解
mobility	 n. 活动
modernize	 v. 现代化
moist	 adj. 潮湿的
monopoly	 n. 垄断
mortality	 n. 死亡率
motel	 n. 汽车旅馆
motivation	 n. 激励，刺激
mount	 v. 增加
mourn	 v. 哀悼
municipal	 adj. 政府的
narrow	 v. 变窄，缩小
necessity	 n. 必须，必要性
needy	 adj. 贫穷的
neglect	 v. 忽视
negotiation	 n. 协商
neighborhood	 n. 附近
neutrality	 n. 中立
nightmare	 n. 噩梦
nominate	 v. 提名
notion	 n. 想法，观点
numerous	 adj. 无数的
nutritious	 adj. 有营养的
obesity	 n. 肥胖
objective	 n. 目标，目的
oblige	 v. 迫使
obstacle	 n. 阻碍
occur	 v. 发生
offense	 n. 冒犯
oppose	 v. 反对
opposition	 n. 反对
optimistic	 adj. 乐观的
organic	 adj. 有机的
orient	 v. 使适应，使确定方向
outcome	 n. 结果
outdated	 adj. 过时的
outlive	 v. 比……活的时间长
outnumber	 v. 超过
outsource	 v. 外包
outweigh	 v. 超过
overcharge	 v. 多收钱
overexcited	 adj. 过于激烈的
overwhelm	 v. 压倒，战胜
owe	 v. 欠钱
owl	 n. 猫头鹰
panic	 adj. 恐慌的
paradise	 n. 天堂
paralyze	 v. 瘫痪，麻痹
pasture	 n. 牧场
pattern	 n. 模式
pause	 n. 暂停，迟疑
pave	 v. 铺路
payroll	 n. 工资总额
peculiar	 adj. 特有的，奇怪的
penalty	 n. 惩罚
pension	 n. 养老金
perish	 v. 死亡
perspective	 n. 视角，观点
pessimist	 n. 悲观主义者
phenomenon	 n. 现象
philosopher	 n. 哲学家
plot	 n. 情节
poetry	 n. 诗歌
polar	 n. （南、北）极
poll	 n. 民意测验
ponder	 v. 仔细考虑
portion	 n. 部分
pose	 v. 形成
position	 v. 定位，安放； n. 位置，职位
possession	 n. 拥有
potential	 adj. 潜在的 n. 潜力
potentially	 adv. 潜在地
practical	 adj. 实践的；实用的
precedent	 n. 先例
precision	 n. 精确性
predict	 v. 预测
predominantly	 adv. 占主导地位地
preference	 n. 偏爱
preindustrial	 adj. 工业化以前的
prejudice	 n. 偏见
premium	 n. 奖金
prescribe	 v. 开处方
present	 v. 呈现，给予
presentation	 n. 展示，讲话
presidency	 n. 总统任期
prestige	 n. 名声，声望
previous	 adj. 之前的
priceless	 adj. 无价的，难以用价格衡量的
primitive	 adj. 原始的，简单的
principle	 n. 原则
prior	 adj. 优先的，先前的
private	 adj. 私人的
procedure	 n. 程序
productivity	 n. 生产力
profitable	 adj. 有利可图的，有利益的
profound	 adj. 深刻的，博学的
prolonged	 adj. 长时间的
promote	 v. 促进
promotion	 n. 促销
prompt	 v. 敦促
property	 n. 财产
propose	 v. 提出
prospect	 n. 前景
prosperity	 n. 繁荣
publicity	 n. 宣传
publicize	 v. 宣传
purchase	 n. 购买
pursue	 v. 追求
puzzling	 adj. 迷惑的，困扰的
quantifiable	 adj. 可量化的
qualification	 n. 资格
qualify	 v. 使有资格
quantity	 n. 数量
quicken	 v. 加快
quota	 n. 配额，销售额
quote	 v. 引用
rally	 n. 集会
randomly	 adv. 随机地
rank	 v. 排列，分级
rape	 n. 强奸
rare	 adj. 罕见的，稀少的
rate	 n. 费用
realm	 n. 领域，方面
reap	 v. 收割，收货
recall	 v. 回忆起，想起
receipt	 n. 发票
reception	 n. 接待
recipe	 n. 秘方，食谱
reckless	 adj. 鲁莽的
reckon	 v. 认为，评价
reconcile	 v. 使和解，使一致；调解
recruit	 v. 招聘
recurrence	 n. 再次发生
reflect	 v. 思考，反映，反射
reflective	 adj. 深思熟虑的；反映的，反射的
refreshing	 adj. 新鲜的
regain	 v. 重新获得
registration	 n. 注册，登记
regulation	 n. 管理，规则
reimbursement	 n. 返还费用
reinforce	 v. 增强，提高
release	 v. 释放，发布
relevant	 adj. 相关的
reliable	 adj. 可靠的
relieve	 v. 减轻，缓解
relieved	 adj. 轻松的，缓解的
reluctance	 n. 勉强，不情愿
remarkable	 adj. 显著的，杰出的
remove	 v. 消除，移除；更新
replacement	 n. 代替
representative	 n. 代表
reproduction	 n. 繁殖
reservation	 n. 预定
resident	 n. 居民
resign	 v. 辞职
resist	 v. 抵制
resolute	 adj. 坚定的
resort	 n. 度假胜地
respective	 adj. 各自的
responsibility	 n. 责任
responsive	 adj. 灵敏的，反应的
restrict	 v. 限制
resume	 n. 简历
retailer	 n. 零售商
reunion	 n. 团聚
reveal	 v. 揭露
revenue	 n. 收入
reverse	 adj. 相反的
revive	 v. 复苏
revolutionize	 v. 革命化
rewarding	 adj. 有回报的
ridiculous	 adj. 滑稽的，可笑的
rigorous	 adj. 严格的
ritual	 n. 仪式
robbery	 n. 抢劫
romantic	 adj. 爱情的
ruin	 v. 毁坏
rustle	 v. 发出沙沙声
sample	 n. 样本，样品
scandal	 n. 丑闻
scarcity	 n. 缺乏
scare	 n. 恐吓，惊恐
scent	 n. 味道
schedule	 n. 时间表
sculpture	 n. 雕塑
sector	 n. 部门
sensible	 adj. 理智的
server	 n. 服务器
session	 n. 会议，学年
severity	 n. 严重性
sexism	 n. 性别歧视
shade	 v. 掩盖
shady	 adj. 阴凉的
shareholder	 n. 股东
shed	 v. 流出
sheer	 adj. 纯粹的
shepherd	 v. 引导，带领
shift	 v. 转变
shot	 n. 照相，照片
shrewd	 adj. 精明的
shrink	 v. 缩减，缩小
shrug	 v. 耸肩
shuttle	 n. 航天飞机
signal	 v. 标志
significant	 adj. 重要的
signify	 v. 表明，象征
simultaneous	 adj. 同步的
skeptical	 adj. 怀疑的
skip	 v. 跳过
skyrocket	 v. 猛增
skyscraper	 n. 摩天大楼
slack	 adj. 疲软的，萧条的
slash	 v. 削减
slight	 adj. 轻微的
slim	 adj. 苗条的
smuggle	 v. 走私
solid	 adj. 坚实的，稳固的
solution	 n. 解决，溶液
soothe	 v. 安慰，减轻
sophisticated	 adj. 复杂的，老于世故的
spacious	 adj. 宽敞的
specialist	 n. 专家
species	 n. 物种
specific	 adj. 具体的
specification	 n. 说明书
spectacle	 n. 景象
sponsor	 v. 赞助, 赞助商
spot	 n. 点 v. 发现
spread	 v. 传播，扩散
squalor	 n. 肮脏
standardize	 v. 标准化
startle	 v. 使惊讶
steady	 adj. 稳定的
stereotype	 n. 刻板印象，固有印象
stimulate	 v. 刺激，激励
stockbroker	 n. 股票经理人
stove	 n. 炉子
straightforward	 adj. 直接的
strain	 n. 压力
strategy	 n. 策略
stray	 n. 迷路，流浪
stress	 v. 强调
strike	 n. 罢工
strip	 n. 狭长的一块
stuff	 n. 材料，东西
submerge	 v. 淹没
submit	 v. 提交
subsidy	 n. 补助
substance	 n. 物质
subtle	 adj. 微妙的
suburban	 adj. 郊区的
supervisor	 n. 督导
surgical	 adj. 手术的
suspect	 v. 怀疑 n. 嫌疑犯
suspicious	 adj. 怀疑的
sway	 v. 影响
switch	 v. 转换
sympathetic	 adj. 同情的
symptom	 n. 症状
tackle	 v. 解决，处理
tangled	 adj. 复杂的，纠缠的
tank	 n. 水箱
temptation	 n. 诱惑
testify	 v. 证明，检验
testimony	 n. 证词
texture	 v. 质地
therapy	 n. 疗法
threat	 n. 威胁
threaten	 v. 威胁
threshold	 n. 门槛
tough	 adj. 困难的，粗暴的
trace	 v. 追踪
track	 v. 追踪 n. 轨迹，踪迹
tragedy	 n. 悲剧
trap	 v. 捕捉
trend	 n. 趋势
trigger	 v. 引发，引起
tropical	 adj. 热带的
tuition	 n. 学费
turbulence	 n. 喧嚣；气流
turtle	 n. 海龟
tutor	 v. 辅导
twist	 v. 扭曲
typical	 adj. 典型的
uncertain	 adj. 不确定的
undecided	 adj. 不确定的
underestimate	 v. 低估
underfunded	 adj. 资金不足的
underlying	 adj. 潜在的，基础的
undertake	 v. 承担；着手，开始
undertaking	 n. 任务，事情
undocumented	 adj. 无证明的
unethical	 adj. 不道德的
uneven	 adj. 不均衡的
unexpected	 adj. 意想不到的
unified	 adj. 统一的
unprecedented	 adj. 史无前例的
unrealistic	 adj. 不现实的
unstable	 adj. 不稳定的
untiring	 adj. 不知疲倦的
untrustworthy	 adj. 不值得信任的，怀疑的
urban	 adj. 城市的，都市的
urbanization	 n. 城市化
urge	 v. 催促
urgent	 adj. 急迫的
utilization	 n. 利用
validity	 n. 有效性，真实性
variation	 n. 变化
vary	 v. 变化
vegetarian	 n. 素食主义者
vehicle	 n. 车辆
vessel	 n. 血管
victim	 n. 受害者
view	 v. 看待
viewpoint	 n. 观点
violation	 n. 违反
violent	 adj. 暴力的
virtual	 adj. 实际的，虚拟的
virtually	 adv. 几乎
virus	 n. 病毒
vitamin	 n. 维他命
vulnerable	 adj. 脆弱的, 易受影响的
welfare	 n. 福利
widespread	 adj. 广泛传播的
wildfire	 n. 森林大火
wildlife	 n. 野生动物
wishful	 adj. 一厢情愿的
wonder	 v. 想知道，好奇
workload	 n. 工作量
yield	 v. 产生
deposit	 v. 存放 n. 存款
receptionist	 n. 接待员
particle	 n. 粒子，微粒
furnish	 v. 提供
elaborately	 adv. 复杂地，精心设计地
infectious	 adj. 感染的，传染的
diagnose	 v. 诊断
cripple	 n. 残疾，跛子
aggressive	 adj. 挑衅的
aptly	 adv. 适当地
assimilate	 v. 同化
consistent	 adj. 一致的
suspend	 v. 暂停
ingenuity	 n. 创造力
reserved	 adj. 保留意见的；矜持的
unbiased	 adj. 公正的
disposal	 n. 支配；处理
inferior	 adj. 比……差
stabilize	 v. 使稳固，使安定
fertility	 n. 多产，肥沃
bleak	 adj. 荒凉的
soar	 v. 高飞
optimism	 n. 乐观
ambition	 n. 野心，报复
pragmatic	 adj. 务实的，讲求实际的
compromise	 v. 妥协；危害
perpetual	 adj. 永久的
dispensable	 adj. 可有可无的
assault	 n. 攻击
transcend	 v. 超越
inherent	 adj. 固有的
baffle	 v. 使迷惑，困惑
stain	 n. 污渍，污点
peer	 n. 同龄人
isolate	 v. 使隔离
abolition	 n. 废除
slavery	 n. 奴隶制度
script	 n. 脚本，剧本
manuscript	 n. 手稿
trait	 n. 特点
deviate	 v. 偏离
overwhelming	 adj. 压倒性的
successively	 adv. 接连着地，继续地
visualize	 v. 想象
underrepresented	 adj. 未被充分代表的
tap	 v. 轻敲, 导出
extinguish	 v. 熄灭；使消亡
toxic	 adj. 有毒的
postdoctoral	 adj. 博士后的
recommend	 v. 推荐
consultation	 n. 商议
determine	 v. 决定
confidential	 adj. 机密的
curriculum	 n. 课程
cafeteria	 n. 自助餐厅
trim	 v. 修剪
expel	 v. 开除，驱逐
refine	 v. 精炼；使……文雅
suicide	 n. 自杀
manual	 adj. 手工的；体力的
alphabetical	 adj. 按字母表顺序的
bloom	 v. 开花，茂盛
fertilizer	 n. 肥料
plough	 n. 犁
affiliate	 v. 使隶属于
hazardous	 adj. 危险的
instantaneous	 adj. 即时的，瞬间的
intrinsic	 adj. 本质的，固有的
paradox	 n. 悖论
grateful	 adj. 感激的
modify	 v. 改变
consent	 n. 同意
intuitive	 adj. 直觉的
scaffolding	 n. 脚手架
outperform	 v. 胜过
discern	 v. 识别
lawsuit	 n. 诉讼
ruling	 n. 裁定
designate	 v. 指定，委派
endorsement	 n. 支持
tasteless	 adj. 没有味道的
brilliant	 adj. 才华横溢的；极好的
fabric	 n. 布料
vocational	 adj. 职业的
carpentry	 n. 木工业
ventilate	 v. 使通风
embody	 v. 体现
tedious	 adj. 冗长的
deduction	 n. 扣款
fluctuate	 v. 波动
simultaneously	 adv. 同步地，同时地
craft	 n. 手艺 v. 精巧地制作
facilitate	 v. 使便利；促进
deteriorate	 v. 恶化
hasten	 v. 加速
specialize	 v. 专业从事
liberation	 n. 解放
pursuit	 n. 追求
bemoan	 v. 抱怨；惋惜
evolve	 v. 进化
fluently	 adv. 流利地
composition	 n. 作文
literal	 adj. 字面的
honorary	 adj. 荣誉的
hurl	 v. 猛投
confer	 v. 授予
notoriously	 adv. 臭名昭著地
validation	 n. 证实
jeopardize	 v. 危害，危及
allegedly	 adv. 据说
vigorous	 adj. 积极的；精力充沛的
fake	 n. 假货
contestant	 n. 参赛者
column	 n. 专栏
hasty	 adj. 匆忙的
linger	 v. 逗留，徘徊
inheritance	 n. 继承；遗产
worldly	 adj. 世间的，尘世的
dimension	 n. 尺寸；维
eligible	 adj. 适合的；胜任的
permanent	 adj. 永久的
memorize	 v. 熟记
evaluation	 n. 评价
literacy	 n. 教育；文化
enviable	 adj. 值得羡慕的
bipartisan	 adj. 两党的
amend	 v. 修订
interpret	 v. 解释；口译
access	 v. 取得，获取
champion	 v. 支持，拥护
navigate	 v. 航行，驾驶
intertwine	 v. 交织，纠缠
collaborate	 v. 合作
evaluate	 v. 评价
domain	 n. 领域
accumulate	 v. 积累
persistent	 adj. 坚持不懈的，持续的
boast	 v. 自夸
assume	 v. 假定，认为
forthcoming	 adj. 即将来临的
mysteriously	 adv. 神秘地
spoil	 v. 溺爱
complement	 n. 补充
immersive	 adj. 沉浸的，身临其境的
cognitive	 adj. 认知的
rhetorical	 adj. 修辞的
impair	 v. 损害
competent	 adj. 能胜任的，有能力的
undermine	 v. 暗中削弱
incompatibility	 n. 不兼容
superficial	 adj. 表面的
endanger	 v. 使……危险
practice	 n. 做法
decode	 v. 解码
immigration	 n. 移民
inescapable	 adj. 不可避免的
utterly	 adv. 完全地，彻底地
inanimate	 adj. 无生命的
irreversible	 adj. 不可逆的；不可取消的
incalculable	 adj. 不可估量的，无法计算的
bump	 v. 颠簸
demonstration	 n. 展示；游行
desert	 v. 放弃，抛弃
jail	 n. 监狱
cozy	 adj. 舒适的
lounge	 n. 休息室
worship	 v. 崇拜，喜爱
seasick	 adj. 晕船的
interfere	 adj. 干涉，妨碍
tension	 n. 紧张
transition	 n. 过渡
accidentally	 adv. 偶然地，意外地
exertion	 n. 运用
impart	 v. 传授，教授
provoke	 v. 激怒
assumption	 n. 假设
formula	 n. 公式
overlap	 v. 重叠
thrive	 v. 繁荣，兴旺
chronic	 adj. 长期的；慢性的
adversity	 n. 逆境
endure	 v. 忍受
assert	 v. 主张，断言
chew	 v. 咀嚼；深思
tradeoff	 n. 权衡，交易
commentator	 n. 评论员
vice	 n. 恶意，恶习
attribute	 v. 归因于
vivid	 adj. 生动的
upgrade	 v. 升级
prospective	 adj. 未来的，预期的
regime	 n. 制度，管理体制
appeal	 n. 请求，呼吁, 上诉
weave	 v. 织布，编织
sew	 v. 缝上，缝纫
nap	 n. 小睡
row	 v. 划船
helicopter	 n. 直升飞机
conquer	 v. 征服
memorandum	 n. 备忘录
clarity	 n. 清晰，清楚
carpenter	 n. 木匠
drummer	 n. 鼓手
discrimination	 n. 歧视
uninformed	 adj. 无知的，未受过教育的
entitle	 v. 使具有资格
imitate	 v. 模仿
subordinate	 adj. 次要的，从属的
suppress	 v. 镇压，压制
throne	 n. 王位
athletics	 n. 体育运动
coach	 n. 教练
biodiversity	 n. 生物多样性
accommodate	 v. 适应，容纳
ultimate	 adj. 最终的
invasive	 adj. 入侵的
underscore	 v. 强调
ongoing	 adj. 持续的，不间断的
greedy	 adj. 贪婪的
lessen	 v. 减少
incur	 v. 引起，导致
integral	 adj. 完整的
merge	 v. 合并
unintentionally	 adv. 无意地
grave	 adj. 严重的
intimate	 adj. 亲密的
alleviate	 v. 减轻，缓解
conspicuous	 adj. 显著的
territory	 n. 领域，领土
displace	 v. 取代
regardless	 adj. 不管，不顾
duplication	 n. 复制品
overturn	 v. 推翻
identical	 adj. 相同的
miniature	 adj. 微型的
tempting	 adj. 吸引人的
segregation	 n. 隔离
variance	 n. 不同
inaction	 n. 不作为
conserve	 v. 保留，保护
renewable	 adj. 可再生的
embrace	 v. 采纳，接受
counterpart	 n. 对等物
rival	 n. 对手
intense	 adj. 激烈的，强烈的
aspirational	 adj. 渴望的
transform	 v. 转变
grip	 n. 抓住
unfold	 v. 展开
ideological	 adj. 意识形态的
filter	 v. 过滤
pronoun	 n. 代词
philosophy	 n. 哲学
illuminate	 v. 阐释，阐明
odds	 n. 可能性
confess	 v. 承认
manipulate	 v. 操纵
rhythm	 n. 节奏
hijack	 v. 劫持
sweep	 v. 扫除，清除
withdraw	 v. 撤销，撤退
flame	 n. 火焰
spark	 n. 火花
feasibility	 n. 可行
fascinate	 v. 使着迷
crew	 n. 机组人员
cumulative	 adj. 积累的
awkward	 adj. 尴尬的，棘手的，笨拙的
obscurity	 n. 默默无闻
badge	 n. 标记, 徽章
distinction	 n. 区分
formulate	 v. 制定，规划
monetary	 adj. 货币的
portray	 v. 描述
hostility	 n. 敌意
robust	 adj. 强健的
appropriation	 n. 挪用
deforestation	 n. 砍伐森林
puzzle	 v. 迷惑
migration	 n. 迁徙，移居
constrain	 v. 限制
sneak	 v. 溜走
margin	 n. 利润
division	 n. 分歧
privilege	 n. 特权
imperial	 adj. 帝国的
justice	 n. 公平
opponent	 n. 反对者
crush	 v. 压碎，压榨
harness	 v. 管理，控制
monopolize	 v. 垄断
tremendous	 adj. 巨大的
vital	 adj. 重要的
imperative	 adj. 必须的,必要的
initial	 adj. 初步的，最初的
distract	 v. 分心，分散注意
convincing	 adj. 令人信服的
consult	 v. 咨询
agony	 n. 痛苦
refrain	 v. 抑制，避免
thrilling	 adj. 令人兴奋的
prematurely	 adv. 早熟地，过早地
conscientious	 adj. 有良心的，认真负责的
entail	 v. 使需要，使必须
forge	 v. 铸造；伪造
overstate	 v. 夸张
accountable	 adj. 应负责的，有责任的
pessimistic	 adj. 悲观的
subsequently	 adv. 随后
hack	 v. 黑客攻击
liability	 n. 责任；债务
conversion	 n. 转变
needle	 n. 指针，针
deterioration	 n. 恶化，退化
fault	 n. 过失
relay	 v. 接替，转播
shrank	 v. 收缩(shrink过去式)
transmit	 v. 传播，传导
incidentally	 adv. 顺便地，附带
notably	 adv. 显著地，尤其
worldwide	 adv. 世界范围地，全世界
rigor	 n. 严格
readjust	 v. 重新调整，再调整
prolong	 v. 延长
redefine	 v. 重新定义
controversial	 adj. 受到争议的
degeneration	 n. 退化，变质
malicious	 adj. 恶毒的
widen	 v. 拓宽，变宽
density	 n. 密度
metropolitan	 adj. 大都市的
prominent	 adj. 卓越的，突出的
prevalence	 n. 流行，普遍
compact	 adj. 紧密的，紧凑的
correlation	 n. 相关，关联
simulate	 v. 模拟，模仿
momentum	 n. 动力，势头
fixture	 n. 固定装置
proposition	 n. 提议，主题
dynamics	 n. 动力学
descent	 n. 血统, 后裔
affiliation	 n. 隶属关系，单位团体
perception	 n. 看法；意识
permeate	 v. 渗透
recruiter	 n. 招聘者
dilute	 v. 稀释，冲淡
prioritize	 v. 优先
privileged	 adj. 有特权的
landmark	 adj. 有重大意义或影响的
extracurricular	 adj. 课外的
deprivation	 n. 剥夺，匮乏
cater	 v. 迎合
pierce	 v. 刺穿
surpass	 v. 超过
target	 v / n. 目标；把…作为目标
ready	 adj. 乐意的，愿意的
alternatively	 adv. 二选一地；非此即彼
chronically	 adv. 慢性地；持久地
frame	 v. 设计，建造
mournful	 adj. 悲哀的；令人惋惜的
cultivate	 v. 培养
cornerstone	 n. 基石
legalize	 v. 合法化
rigid	 adj. 严格的
certify	 v. 保证，证明
orbit	 n. 轨道
astronomical	 adj. 天文数字的
Automatically	 adv. 自动地；不经思考地
existence	 n. 存在，生存
intolerant	 adj. 无法容忍的
occupation	 n. 职业
slightly	 adv. 轻微地
exploit	 v. 开发，开采
regarding	 prep. 关于
ecosystem	 n. 生态系统
noted	 adj. 著名的
incorporate	 v. 合并；体现
interactive	 adj. 互相作用的，互相影响的
novel	 adj. 新颖的
mismanagement	 n. 管理不当
irrational	 adj. 不合理的，不理性的
groundless	 adj. 无理由的，无根据的
restructure	 v. 调整，重建
stimulus	 n. 刺激
feasible	 adj. 可行的
adaptation	 n. 适应；改编
institute	 n. 研究所，学会，学院
biochemistry	 n. 生物化学
entrepreneur	 n. 企业家
arise	 v. 出现
ascend	 v. 上升
combination	 n. 组合，结合
definite	 adj. 一定的，确切的
preserve	 v. 保存，保护
program	 v. 计划，安排
proximately	 adv. 近似，接近
lobbyist	 n. 游说者
redundant	 adj. 过剩的；失业的，被解雇的
insurer	 n. 保险公司；承保人
overestimate	 v. 高估
cropland	 n. 农田
irrigation	 n. 灌溉
contaminate	 v. 污染，弄脏
untreated	 adj. 未经处理的
sanitation	 n. 卫生环境，卫生设备
echo	 v. 随声附和，发出回声
duplicate	 n. 副本，复制品
elevate	 v. 提升，举起；使高兴
illustrate	 v. 阐明，说明
inquire	 v. 询问
prevail	 v. 流行，普遍
strap	 v. 用带帮助
turbulent	 adj. 动荡的，骚乱的
rebellion	 n. 叛逆
lofty	 adj. 崇高的
render	 v. 给予
recyclable	 adj. 可回收利用的
trick	 n. 骗局，诡计
certification	 n. 证明，保证
prevailing	 adj. 流行的
misled	 (mislead过去式)误导
elimination	 n. 消除，淘汰
unqualified	 adj. 不合格的，不胜任的
subconscious	 adj. 下意识的，潜意识的
incompetent	 adj. 无能力的，不胜任的
discriminate	 v. 歧视；区别
elegant	 adj. 高雅的，雅致的
gown	 n. 长袍
bride	 n. 新娘
costume	 n. 服装
