crusade	 n.  十字军东征， 宗教战争
unavailable	 adj.  难以获得的； 不能利用的
forager	 n.  抢劫者； 强征队员
surgeon	 n.  外科医师
seismic	 adj.  地震的， 有关地震的
resemble	 v.  类似于， 像
halo	 v.  围以光环 n. 光环；
rupture	 n.  破裂， 断裂
tranquilizer	 n.  镇定剂
convection	 n.  对流
wreck	 n.  失事船只； 残骸
carcass	 n.  尸体； 畜体； 身躯
virgin	 adj.  处女的； 纯洁的 n. 圣女；
afflict	 v.  使痛苦， 折磨
constrict	 v.  收缩； 使狭窄
gloomy	 adj.  悲观的
fluctuate	 v.  涨落， 变化
customs	 n.  关税； 海关
calculate	 v.  计算； 估计； 推测
authorize	 v.  授权； 批准， 认可
minivan	 n.  小型货车
conceal	 v.  隐瞒； 隐藏
barracks	 n.  兵营
collinear	 adj.  在同一直线上的
narrative	 adj.  叙述的， 讲故事的； 导航
possess	 v.  具有， 拥有
coincide	 v.  巧合； 一致， 符合
neutral	 adj.  中立的
circular	 adj.  圆形的； 环绕的
devise	 v.  想出； 设计， 发明
apparent	 adj.  显然的， 明显的； 表面上的
marrow	 n.  骨髓， 精华
chronical	 adj.  长期的， 慢性的
triple	 v. 三倍于； n.  三个一组
startlingly	 adv.  令人吃惊地， 惊人地
cellular	 adj.  细胞的； 蜂窝状的
enlightened	 adj.  开明的， 进步的
inefficient	 adj.  效率低的； 无能的， 不称职的
statute	 n.  【律】 法令， 条例
placate	 v.  安抚
cardiac	 adj.  心脏的； 心脏病的
humble	 adj.  谦逊的； 地位 低下的
accessible	 adj.  易达到的； 易受影响的
commodity	 n.  商品
statistical	 adj.  统计的； 统计学的
landownership	 n.  土地所有权
authenticate	 v.  证明…是真的
independent	 adj. 独立的，单独的； n.  独立自主者； 无党派者
cliff	 n.  悬崖， 峭壁
concede	 v.  让步； 承认
unparalleled	 adj.  无比的， 空前的
plausible	 adj.  似是而非的， 貌似有理的
wreak	 v.  发泄； 引起
evaporate	 v.  蒸发； 消失
luminosity	 n.  光度， 发光度
resuscitation	 n.  复活； 恢复
fervent	 adj.  强烈的， 热烈的
commission	 v.  委托 n. 委员会；佣金；
flip	 v. 轻弹；按；蹦跳 adj.  无礼的； 冒失的； 轻率的
rational	 adj. 合理的，理性的； n.  有理数
rescind	 v.  废除
resume	 v. 重新开始，继续； n.  简历
editorial	 adj.  编辑的； 社论的 n. 社论；
sedimentary	 adj.  沉积的， 沉淀性的
glucose	 n.  葡萄糖
kernel	 n.  果仁； 核心
spiral	 adj. 螺旋形的； v. 盘旋上升； n.  螺旋
metabolize	 v.  使新陈代谢
helium	 n.  氦
excavate	 v.  挖掘， 掘出
halt	 v.  使停止 n. 停止，休息；
inhalation	 n.  吸入
subtle	 adj.  细微的
viscosity	 n.  黏性， 黏度
component	 n.  成分； 要素
overwhelm	 v.  淹没； 压倒； 不知所措
impartial	 adj.  不偏不倚的， 公正的
consultant	 n.  顾问； 咨询者
encephalitis	 n.  【医】 脑炎
unprecedented	 adj.  前所未有的， 史无前例的
stature	 n.  身高
poach	 v.  偷猎； 水煮
quarantine	 n.  隔离检疫期
illustration	 n.  说明； 例证； 图解
arch	 adj.  调皮的， 淘气的 n. 拱形；拱门；
wrap	 v.  包， 裹
novel	 adj.  新颖的； 新奇的 n. 小说；
prominence	 n.  突出物； 突出
reimburse	 v.  偿还
inaccessible	 adj.  难达到的， 难接近的， 难见到的
genial	 adj.  亲切的； 和蔼的
resolve	 v.  解决； 分解； 决心
landlocked	 adj.  为陆地所包围的
confront	 v.  面对； 面对挑战
obese	 adj.  肥胖的
dominate	 v.  支配； 在…占首要地位
imitate	 v.  模仿； 仿造
compute	 v.  计算； 估算； 推断
reproduce	 v.  繁殖； 复制
skeleton	 n.  骨架， 骨骼
institution	 n.   社会公共机构； 制度， 习俗
pad	 v.  填补 n. 便笺本；衬垫；
illiterate	 n.  文盲
homestead	 n.  宅地； 家园
delinquent	 adj.  拖欠的； 违法的 n. 行为不良的人；
intersection	 n.  交叉点； 【数】 交集
disperse	 v.  分散， 散布
implement	 v.  实施， 贯彻
cosmetic	 n.  化妆品
export	 v&n.  出口， 输出
inquisitive	 adj.  好奇的
erratic	 adj.  反复无常的； 古怪的
par	 n.  同等
incinerate	 v.  焚化； 毁弃
well-being	 n.  健康， 幸福； 福利
vicious	 adj.  邪恶的； 恶性的
deform	 v.  使变形
erode	 v.  侵蚀；  削弱， 损害
aviator	 n.  飞行家， 飞行员
enormous	 adj.  巨大的， 极大的
moisture	 n.  水分； 湿度
sulfuric	 adj.  硫磺的； 含多量硫磺的
sloth	 n.  树獭； 懒惰
sane	 adj.  健全的； 明智的
frustrate	 v.  挫败； 沮丧
external	 adj.  外面的， 表面的
sparse	 adj.  稀少的， 贫乏的
circumstance	 n.  环境； 事件
pragmatic	 adj.  实际的， 注重实效的； 实用主义的
revise	 v.  修订； 修改
treasury	 n.  [常the T~]财政部； 国库； 国库券 issued by the Treasury)
authority	 n. 权力；
methane	 n.  甲烷， 沼气
paramount	 adj.  最重要的， 决定性的
longitudinal	 adj.  长度的； 纵向的； 经线的
single-entry	 adj.  单式的； 单式记录的
legislature	 n.  立法机关， 立法团体
deleterious	 adj.  有害的
neural	 adj.  神经 的
semiconductor	 n.  半导体
provided	 conj.  假如， 倘若
inmate	 n.  居民， 同住者
clinging	 adj.  黏着的
instrument	 n.  仪器； 手段； 工具
medium	 adj. 〔大小、水平或数量〕中等的；中号的 n. 传播媒介〔如报纸、电视等〕 n. 灵媒，巫师，通灵的人
indispensable	 adj.  必不可少的
representation	 n.  代表
hormone	 n.  荷尔蒙； 激素
fatal	 adj.  致命的
disenfranchise	 v.  剥夺…的公民权
electro	 n.  电镀物品， 电版
outstrip	 v.  超过， 胜出
caffeine	 n.  咖啡因
elliptical	 adj.  椭圆形的
behavioral	 adj.  行为的
wrestle	 v.  摔跤； 搏斗； 深思
motivate	 v.  激发， 刺激
projection	 n.  预测； 规划
ridge	 n.  山脊， 岭
peat	 n.  泥煤
multiply	 v.  乘； 增加
pasture	 n.  牧场， 牧草
malpractice	 n.  治疗失当
engender	 v.  产生； 引起
hypothesize	 v.  假定， 假设
approval	 n.  批准； 认可； 赞成
raffle	 n.  抽奖
multiple	 n.  倍数
lucrative	 adj.  赚钱的； 有利可图的
peak	 adj. 最高的； v.  到达最高点 n. 顶点；
portrait	 n.  肖像； 相片
magnet	 n.  磁铁， 磁体
concentrate	 v.  聚集， 浓缩
versatile	 adj.  多才多艺的； 多用途的
explosion	 n.  爆炸， 爆发
acidity	 n.  酸度， 酸性
pastoral	 adj. 乡村的，农村的； n.  牧歌； 田园诗 dealing with shepherds or rural life)
complaint	 n.  抱怨， 诉苦； 疾病
automate	 v.  自动化
et al	 adv. 以及其他〔有关的〕人；等人
permit	 v.  允许， 许可 n.  通行证， 许可证
personnel	 n.  全体人员； 人事部门
biodegradable	 adj.  可由生物降解的
lamellar	 adj.  薄膜的； 薄层状的
indifference	 n.  冷漠， 不关心
porcelain	 n.  瓷； 瓷器
catalog	 v.  为…编目录 n. 商品目录；
focus	 v. 聚焦，集中； n.  震源， 震中
hamper	 v.  阻碍； 牵制
exterminate	 v.  消除， 消灭
smuggler	 n.  走私者
Puritan	 adj.  清教徒的 n. 清教徒；
pollinate	 v.  授粉， 传粉
rhinoceros	 n.   犀牛
implication	 n. 含义；
fierce	 adj.  残酷的； 凶猛的
precursor	 n.  先驱； 先兆； 前身
reservation	 n.  预订； 保存； 自然保护区
block	 v. 阻碍；堵塞； n.  街区
revive	 v.  复苏； 恢复
microcomputer	 n.  微型计算机
promotional	 adj.  促销的； 增进的
wage	 v. 发动； n.  工资
arid	 adj.  干旱的； 荒芜的
scurrilous	 adj.  粗俗的； 诽谤的
fiber	 n.  纤维
proceed	 v.  继续进行
psychopath	 n.  精神变态者
corporation	 n.  公司； 法人
dismiss	 v.  解散； 解雇
underlying	 adj.  在下面的； 根本的， 基础的
resonance	 n.  共振
turbulence	 n.  骚乱， 动荡
intelligence	 n.  智力； 情报
mutation	 n.  突变， 变异
fallow	 adj.  休耕的
install	 v.  安装， 安置
integration	 n.  集成； 综合
indication	 n.  指示； 迹象
foreseeable	 adj.  可预知的； 能预测的
microscopic	 adj.  极小的
bulk	 n.  主体， 绝大部分
vaccination	 n.  接种疫苗； 牛痘疤
ceramic	 adj.  陶的， 制陶的
renovation	 n.  整修； 革新
circuit	 n.  电路； 环道
locomotion	 n.  运动， 移位
gut	 v. 毁坏〔建筑物〕的内部〔尤指烧毁〕
foraging	 n.  觅食
restrict	 v.  限制； 约束
mandatory	 adj.  强制的， 命令的
caterpillar	 n.  毛虫
prevalence	 n.  流行； 普遍
scrap	 v. 扔弃； adj.  零碎的 n. 碎屑，废物；
conjunction	 n.  结合， 联合； 连接词
syndrome	 n.  综合症状
peer	 v.  凝视 n. 同等之人，同辈；
persecute	 v.  迫害
imperative	 adj.  必要的； 紧急的； 命令的
hitherto	 adv.  迄今， 到目前为止
succession	 n.  连续； 继位； 【生】 自然演替
accordingly	 adv.  因此； 相应地
consequence	 n.  结果； 重要； 推论
robust	 adj.  健壮的
linear	 adj.  线的； 直线的
occupational	 adj.  职业的； 占领的
reinvest	 v.  再授给； 再投资
peel	 v. 削…的皮； n.  皮
ballistic	 adj.  弹道的， 发射的
ascending	 adj.  上升的
reclaim	 v.  收回； 恢复
inconsistent	 adj.  不一致的， 矛盾的
denounce	 v.  公然抨击； 告发
verge	 n.  边缘
allergic	 adj.  过敏的； 对…讨厌的
framework	 n.  框架
milieu	 n.  环境
pivotal	 adj.  中枢的； 重要的
fundraise	 n.  募捐
microorganism	 n.  微生物
constraint	 n.  约束， 抑制
entity	 n.  实体； 统一体
chronicle	 n. 编年史，年代记 v. 将〔一系列事件〕载入编年史中，按时序记载
infect	 v.  感染； 使恶化
depletion	 n.  消耗， 损耗
prohibit	 v.  禁止； 阻止
frugal	 adj.  节约的， 节俭的
franchise	 n.  特权； 经销权
fuel	 v.  给…加燃料； 刺激； 推动 n. 燃料；
irreversible	 adj.  不可改变的
reign	 n.  统治
celestial	 adj.  天体的， 天空的
foresee	 v.  预见
associate	 adj. 联合的； v.  将人或事物联系起来 n.  合伙人
scrupulous	 adj.  谨慎的； 严格认真的
identical	 adj.  同一的； 相同的
plead	 v.  作为辩护或理由提出
buttress	 v.  支持 n. 扶壁；
kidney	 n.  肾脏
lactic	 adj.  乳的
lag	 v.  落后
glean	 v.  收集， 采集
automation	 n.  自动装置
ambitious	 adj.  有抱负的， 雄心勃勃的； 宏大的
centrality	 n.  中心性； 向心性
contemptuous	 adj.  轻蔑的， 傲慢的
charity	 n.  慈善； 慈善团体
coral	 n.  珊瑚； 珊瑚虫
academic	 adj. 学院的；学术的； n.  学者
function	 v. 运行；起作用； n.  职责； 作用； 功能
stationery	 n.  文具； 信纸  for writing or typing)
smokestack	 n.  烟囱
stock	 v.  储备 n. 股票；库存；
representative	 adj.  有代表性的， 典型的 n. 代表；
comparison	 n.  比较， 对照； 比喻
endothermic	 adj.  【动】 温血的， 恒温的
ritual	 adj.  仪式的 n. 仪式；
surge	 v&n.  汹涌； 猛增
dispense	 v.  分配， 分发
hatch	 v.  孵出， 孵化
pernicious	 adj.  有害的； 致命的
splinter	 n.  碎片
revert	 v.  恢复原状
indiscriminate	 adj.  不加区别的； 不受限制的
herbivore	 n.  【动】 食草动物
reconcile	 v.  调停， 调解； 调和， 使一致； 使协调， 使和解
condition	 n.  条件； 情况； 环境
tempt	 v.  引诱， 吸引
peddle	 v.  兜售， 叫卖
ethic	 n.  道德标准， 行为准则
indistinguishable	 adj.  难区分的， 不能分辨的
catalytic	 adj.  催化的， 起催化作用的
abdicate	 v.  放弃， 丢弃
metabolism	 n.  新陈代谢
evil	 n.  邪恶； 坏事， 恶行
cartel	 n.  卡特尔
cardiopulmonary	 adj.  心肺的； 与心肺有关的
forthcoming	 adj.  将来的； 现成的， 随要随到的
patriotic	 adj.  爱国的， 有爱国心的
dislocation	 n.  混乱， 紊乱
perplex	 v.  使困惑； 复杂化
complication	 n.  并发症； 复杂， 复杂化
irradiate	 v.  照射； 使明亮， 生辉
university	 n.  大学， 高校
censure	 v.  指责， 谴责 n. 指责，谴责；
chatter	 v.  喋喋不休地说； 颤动
combat	 v. 与…作战；同…斗争； adj.  战斗的 n. 战斗；
despise	 v.  轻视， 轻蔑
plywood	 n.  胶合板
dioxide	 n.  二氧化物 containing two atoms of oxygen in the molecule)
levy	 v&n.  征税
indulge	 v.  享受； 沉湎于； 放纵
pursue	 v.  追求； 追击； 继续
haze	 n.  霾， 薄雾
catastrophe	 n.  灾难， 灾祸
convey	 v.  运载， 运送； 表达
detrimental	 adj.  损害的， 造成伤害的
skull	 n.  头骨
possibility	 n.  可能性
lane	 n.  行车道
contaminate	 v.  污染； 感染
allude	 v.  间接提到， 暗指
malarial	 adj.  患疟疾的； 毒气的
elevation	 n.  高地； 海拔； 正面图
resurgence	 n.  复苏， 复兴
predator	 n.  食肉动物
accord	 v. 同意；一致； n.  协议
forfeit	 v.  丧失 n. 罚金；
updraft	 n.  上升气流)
automatic	 adj.  自动的； 无意识的
citywide	 adj.  全市的， 全市性的
inspector	 n.  检查员； 巡视员
consecutive	 adj.  连续的， 连贯的
probe	 v. 探索； n.  探测器
quotient	 n.  【数】商
dexterity	 n.  纯熟， 灵巧
merchandise	 v. 买卖，销售；经商； n.  商品
encyclopedia	 n.  百科全书
conduct	 v.  实施， 指导； 传导 n.  行为
inflate	 v.  充气； 抬高； 膨胀
velvet	 adj. 天鹅绒的； n.  天鹅绒 characterized by a short soft dense warp pile)； 天鹅绒似的东西
quantitative	 adj.  量的， 量的
harness	 v.  利用 n. 马具；
drainage	 n.  排水； 排水系统； 污水
equilibrium	 n.  平衡
sketch	 v.  画速写 n. 草图，素描；
maintenance	 n.  维护， 维修； 保持
cluster	 v.  使聚集在一起 n. 群，堆，团；
prey	 v.   捕食 n. 被掠食者；
apparatus	 n.  仪器， 设备
expedition	 n.  远征队， 探险队
neuron	 n.  神经元， 神经细胞
vertebrate	 adj.  (鸟兽等)有脊柱的(having a spinal column) n. 脊椎动物ofchordatespossessingaspinalcolumnthatincludesthemammals,birds,reptiles,amphibians,andfishes)；
concert	 n.  一致； 音乐会
decay	 v&n.  腐朽； 衰退
advertising	 n.  广告； 广告业
absorb	 v.  吸收； 同化
osmotic	 adj.  渗透的， 渗透性的
creditworthiness	 n.  有资格接受信用贷款
circulate	 v.  散布， 传播
revamp	 v.  改造； 修订， 修改
fracture	 n.  骨折； 折断
concern	 v. 涉及，关系到；使担心； n.  关心
incubate	 v.  孵化 so as to hatch by the warmth of the body)； 酝酿
figurine	 n.  小塑像， 小雕像
eventual	 adj.  最后的， 最终的
lessen	 v.  减轻， 减少
refrain	 v.  抑制， 避免
pact	 n.  合同， 条约
merge	 v.  合并； 使合并； 吞没
liable	 adj.  易于…的
etched	 adj.  被蚀刻的
strut	 n.  支柱， 支撑
homing	 adj.  有回家本能的
cargo	 n.  货物
Hispanic	 adj.  西班牙的， 说西班牙语的
apprentice	 n.  学徒； 初学者
dough	 n.  生面团
confidential	 adj.  秘密的
element	 n.  元素， 要素
drift	 v.  漂流， 漂移； 缓慢变动
undue	 adj.  过度的， 不适当的
panacea	 n.  灵丹妙药
sandbar	 n.  沙洲
ergonomic	 adj.  人类环境改造学的； 人类工程学的
abundant	 adj.  大量的， 丰富的； 富裕的； 多的
pigment	 n.  天然色素； 干粉颜料
forecast	 v&n.  预测， 预报
courtesy	 n.  礼貌， 谦恭
deteriorate	 v.  恶化
participatory	 adj.  参与的
aftermath	 n.  结果， 后果
pollutant	 n.  污染物
bisect	 v.  平分
cue	 n.  暗示， 信号
induce	 v.  引诱； 促使， 引起
abnormal	 adj.  反常的
effluent	 n.  支流； 废水
aperiodic	 adj.  不定期的， 非周期性的
vortices	 n.  漩涡
enroll	 v.  入学， 招收； 加入
stereotype	 v.  使…一成不变 n. 铅版；陈规；
molecule	 n.  分子
reminiscent	 adj.  回忆的； 使人联想的
memorandum	 n.  备忘录； 便笺
coaster	 n.  杯垫； 滑坡铁路
resign	 v.  辞职
sophisticated	 adj.  老练的， 精通的； 复杂的
ardent	 adj.  热心的， 热烈的
anomaly	 n.  异常， 反常
warrior	 n.  战士
stave	 n.  狭板， 木柱
entertainment	 n.  娱乐
reside	 v.  居住； 存在
jurisdiction	 n.  管辖权； 管辖区域
concurrent	 adj.  同时发生的
rheumatic	 adj.  风湿病引起的
subtraction	 n.  减法； 减少
aluminum	 n.  铝
cursorial	 adj.  适于行走的， 善于奔跑的
availability	 n.  可用性
indicative	 adj.  标示的， 象征的
scrutiny	 n.  详细审查； 监视； 细看
antifreeze	 n.  抗冻剂
inalienable	 adj.   不可让与的， 不可剥夺的
promote	 v.  提升； 促进
incompatible	 adj.  不能和谐共存的
deluxe	 adj.  豪华的
sacralization	 n.  神化
mononucleosis	 n.  单核细胞增多症
prudery	 n.  过分拘谨， 故作正经
impeachment	 n.  弹劾， 控告
tariff	 n.  关税； 税率
currency	 n.  流通； 货币
distribute	 v.  分配， 分发
reorganization	 n.  改组； 整顿
enlist	 v.  服兵役； 征募 for duty in the armed forces)； 谋取(支持、 赞助等)(to secure the support and aid of)
depreciation	 n.  贬值
retention	 n.  保持， 留住
confederation	 n.  同盟， 联盟
legislation	 n.  立法； 法律
quiz	 n.  小测验
participate	 v.  分担； 参与； 分享
ingredient	 n.  成分， 要素；  配料
surplus	 adj.  剩余的 n. 过剩，剩余；
consolidate	 v.  巩固； 坚强； 合并
gradient	 n.  梯度； 【生】 生理梯度
inhibit	 v.  阻止； 抑制
intimate	 adj.  极为熟知的 v.  暗示 n. 密友；
withdrawal	 n.  撤退； 提款； 取消
biomedical	 adj.  生物医学的
fecundity	 n.  多产； 繁殖力
disparate	 adj.  全异的； 迥然不同的
defiant	 adj.  蔑视的
tragedy	 n.  惨事； 灾难
reflective	 adj.  反射的， 反照的； 深思熟虑的
misrepresent	 v.  歪曲， 不如实地叙述
clan	 n.  部落， 氏族
miniature	 adj. 微型的，小型的； n.  缩小的模型
urchin	 n.  海胆
burglarize	 v.  破门盗窃
chart	 v.  记录， 记载 n. 图表；
cabinet	 n.  贮藏橱， 陈列柜
optical	 adj.  眼的， 视觉的； 光学的
principle	 n.  原则； 原理； 道义
echolocation	 n.  回声定位法
predominantly	 adv.  主要地
antagonism	 n.  对抗， 敌对
litigant	 n.  诉讼人
consortium	 n. 财团，联合企业
embryo	 n.  胚胎
apparel	 n.  衣服， 服饰
accounting	 n.  会计， 会计学； 账单
secure	 v. 获得； adj.  安全的
telecommunication	 n.  远程通信； 无线电通讯
initiate	 v.  开始， 发起
domestic	 adj.  本国的； 家的； 驯养的
infirmary	 n.  医院， 医务室
outsource	 v.  外包
canopy	 n.  顶棚；  树冠层
terrestrial	 adj.  地球的； 陆地的
irrigation	 n.  灌溉
compile	 v.  编辑， 编撰
smelt	 v.  熔炼， 冶炼 often with an accompanying chemical change usually to separate the metal)； 精炼(to refine)
neutron	 n.  中子
bias	 v.  使有偏见 n. 偏见；偏心；
locomotive	 adj.  火车头的； 运动的 n. 机车，火车头；
tile	 v.  铺瓦于 n. 瓦片；瓷砖；
inherent	 adj.  固有的， 内在的
budget	 n.  预算
radiate	 v.  放射， 辐射
encroach	 v.  侵犯， 侵害
pronounced	 adj.  明显的， 显著的
stipulate	 v.  规定； 确定
wary	 adj.  谨慎的， 慎重的
ultimate	 adj.  最终的， 结果的
juror	 n.  陪审团成员
prosecute	 v.  对…提起公诉
adapt	 v.  适合， 适应
batch	 n. 一批；一组
intrinsic	 adj.  固有的， 内在的
lame duck	 n.  任期将满而未能重新当选的官员
pecuniary	 adj.  金钱上的， 金钱的
prepay	 v.  预先支付
median	 adj. 中间的； n.  中线； 中数
vestige	 n.  痕迹， 残余
proximity	 n.  接近
interstellar	 adj.  星际的
district	 n.  地区； 行政区
luminous	 adj.  发光的， 明亮的； 清楚的
arboreal	 adj.  树木的； 栖息在树上的
overall	 adj.  全部的； 整体上； 一般的
maritime	 adj.  海的； 海事的
receipt	 n. 收据；
assume	 v.  假定， 假设； 担任…的职位
poacher	 n.  偷猎者
referendum	 n. 〔为表决某问题的〕全民投票；全民公决
capsule	 n.  胶囊
prank	 n.  恶作剧， 玩笑
millennium	 n. 一千年，千年期
hydroponic	 adj.  溶液培养的， 无土栽培的
impoverished	 adj.  穷困的
untenable	 adj.  难以防守的； 站不住脚的
ozone	 n.  臭氧
specter	 n.  幽灵； 萦绕在心头的恐惧
disaster	 n.  灾难； 彻底的失败
ecology	 n.  生态学， 环境适应学
prudent	 adj.  谨慎的； 精明的
secrete	 v.  藏匿； 【生】 分泌
enhance	 v.  提高， 增加
enclose	 v.  围绕， 包围
overview	 n.  概观， 概述
juxtapose	 v.  并放， 并列
yen	 n.  日元
calcium	 n.  钙
suspicion	 n.  怀疑， 猜疑
purchase	 v. 购买； n.  购买； 支点
assembler	 n.  汇编程序； 装配工
volatile	 adj.  易变的， 多变的
bicker	 v.  争吵， 争论
generic	 adj.  种类的； 类属的
flaunt	 v.  炫耀， 夸耀
endorse	 v.  背书； 支持， 赞同
teem	 v.  充满， 到处都是
optometrist	 n.  验光师
marital	 adj.  婚姻的； 夫妻的
foreshadow	 v.  成为先兆， 预示
clarity	 n.  清楚， 明晰
infrastructure	 n.  基础设施， 公共建设； 下部构造
recipient	 adj.  接受的 n. 接受者；
replete	 adj.  充满的
embargo	 n.  禁运
operagoer	 n.  经常看歌剧的人
whiplash	 n.  鞭绳； 鞭打
incur	 v.  招致； 遭受， 遭遇
nocturnal	 adj.  夜晚的， 夜间活动的
corrosion	 n.  腐蚀， 侵蚀
notorious	 adj.  声名狼藉的
funnel	 v.  汇集， 集中 n. 漏斗；
pall	 n.  幕， 遮盖物
lipoprotein	 n.  脂蛋白
palm	 n.  棕榈； 手掌
pup	 v.  产崽 n. 小狗；幼兽；
hydrogen	 n.  氢
scapegoat	 n.  替罪羊
gland	 n.  【解】 腺
plume	 n.  股， 团； 羽毛； 岩浆柱
consistency	 n.  一致性； 连接
artifact	 n.  手工艺器物； 文物
primate	 n.  灵长类
premise	 n.  前提， 假设
colonize	 v.  建立殖民地， 拓殖
controversial	 adj.  引起或可能引起争论的
dinosaur	 n.  恐龙
attain	 v.  达到， 完成； 获得
tenant	 n.  房客； 佃户
plaintiff	 n.  原告
pedal	 v.  骑脚踏车 n. 踏板，脚蹬；
taxable	 adj.  应纳税的， 可征税的
quadrant	 n.  象限
endemic	 adj. 地方性的； n.  地方病
magnesium	 n.  【化】 镁
infancy	 n.  婴儿期； 初期
supreme	 adj.  最高的； 极度的
heritage	 n.  遗产； 传统
priority	 n.  在先； 优先权； 优先考虑的事
extraction	 n.  取出， 抽出； 抽出物
slope	 n.  斜坡； 【数】 斜率
philosophy	 n.  哲学； 哲理， 见解
inlet	 n.  <口>进水
metallic	 adj.  金属的
creative	 adj.  创造性的
preventive	 adj.  预防的， 防止的 n. 预防药；预防法；
mythology	 n.  神话； 神话学
analog	 n.  类似物
judicial	 adj.  司法的； 公正的
shuttle	 n.  航天飞机； 穿梭运输工具
lapse	 n.  流逝
perfunctory	 adj.  草率的； 敷衍的
regenerate	 v.  再生， 恢复
allocate	 v.  分配； 分派
forestall	 v.  预防， 阻止
eradication	 n.  消灭， 根除
pressboard	 n.  压制板
niche	 n.  壁龛； 【生】 生态龛； 特定市场
antibiotics	 n.  抗生素
primary	 adj.  最初的； 基础的； 首要的
pirate	 v.  盗版 n. 海盗；盗版；
pant	 v&n.  喘， 气喘， 喘息
enterprise	 n.  事业； 企业
solar	 adj.  太阳的； 太阳能的
seesaw	 n.  跷跷板
formation	 n.  组织， 形成；  编队
fetal	 adj.  胎儿的
emigrate	 v.  移居他国
alien	 adj.  外国的； 相异的 n. 外国人；
benefactor	 n.  行善者， 捐助者
triangle	 n.  三角， 三角形
fuse	 v.  熔化， 熔融； 融合
anole	 n.  变色龙
competence	 n.  能力
elite	 adj.  卓越的， 精锐的 n. 精英；
wholesale	 n.  批发
premium	 n.  保险金
listlessness	 n.  倦怠， 无精打采
bucolic	 adj.  乡村的； 田园风味的
solidarity	 n.  团结， 一致
theme	 n.  主题； 题目
consult	 v.  咨询； 商议
electorate	 n.  全体选民
determinism	 n.  决定论
appropriation	 n.  拨款
entice	 v.  诱惑， 引诱
contradiction	 n.  矛盾； 反驳
pang	 n.  阵痛； 极度悲痛
predatory	 adj.  掠夺的； 食肉的
preponderance	 n.  优势； 多数
barrel	 v.  把…装桶 n. 桶；
sentinel	 n.  哨兵
disclosure	 n.  披露， 揭发
desire	 v. 渴望；要求； n.  愿望
initial	 adj.  最初的， 初始的
efficient	 adj.  有效率的； 有能力的
nucleotide	 n.  核苷酸
rudimentary	 adj.  基础的， 初步的； 发育不全的
symbiotic	 adj.  共生的， 共栖的
consistent	 adj.  始终如一的， 一致的； 坚持的
reverse	 v. 取消；逆转； adj.  相反的
infest	 v.  大批滋生， 蔓延
conceptual	 adj.  观念的， 概念的
barren	 adj.  贫瘠的； 没有的， 缺乏的
eternal	 adj.  永久的， 永恒的
redress	 v.  改正； 调整
grove	 n.  树丛， 小果园
fungi	 n.  真菌； 突然发生并迅速发展的东西
antiquity	 n.  古代； 古物
permanent	 adj.  永久的； 固定的
fetch	 v.  售得
foster	 v.  养育， 培养； 加强， 促进
prevalent	 adj.  流行的， 普遍的
facility	 n.  设施， 设备； 容易， 灵巧
gregarious	 adj.  群居的
beam	 v. 堆满笑容； n.  束， 柱
nutrient	 n.  营养物， 滋养物质
civilization	 n. 文明， 文化
compact	 adj. 紧密的； n.  契约
alliance	 n.  联盟； 联合
outlaw	 v. 宣布…为非法； n.  歹徒； 罪犯
outlay	 n.  支出， 费用
bead	 n.  小珠子； 小滴
aviation	 n.  航空； 飞机制造业
eusocial	 adj.  完全群居的
emulate	 v.  效仿； 努力赶上或超越
experience	 v.  经历； 经验 n. 经历；经验；
synthesize	 v.  综合； 合成
upsurge	 n.  急剧上升
flatten	 v.  变平； 彻底打败某人
mammalian	 adj.  哺乳动物的
squash	 v.  镇压； 压扁 n. 南瓜；
thermostat	 v.  为…配备恒温器； 用恒温器控制 n. 恒温器，自动调温器；
denote	 v.  表示， 意味着
renegade	 adj.  背弃的， 离经叛道的
emphasis	 n.  重点； 强调
inscription	 n.  题词； 铭文
propagate	 v.  繁殖； 宣传， 使普及
unionization	 n.  联合， 组织工会
feasible	 adj.  可做的， 可实行的
prescribe	 v.  开， 开处方
potential	 adj.  潜在的， 有可能性的 n. 潜能；可能性；
orthodox	 adj.  正统的， 通常的
necessitate	 v.  需要； 成为必要
accustomed	 adj.  习惯的， 适应的
psyche	 n.  心智， 精神
contraband	 n.  走私； 走私货
adept	 adj.  精通的， 内行的
quadruple	 v.  成四倍
lounge	 n.  长沙发
curiosity	 n.  好奇， 好奇心； 珍品， 古董
rugby	 n.  橄榄球
resist	 v.  抵制， 抵抗； 抗， 耐
format	 v.  格式化 n. 格式，版式；
allotment	 n.  分配； 分配物； 养家费
sacrifice	 v.  牺牲 n. 牺牲；放弃；
particular	 adj.  特殊的， 特别的
illegal	 adj.  违法的， 非法的
corps	 n.  军团
stimulate	 v.  激励； 激发
eclipse	 n.  食； 消失， 衰落
correlate	 v.  和…相关
cataclysmic	 adj.  大变动的
animosity	 n.  憎恶， 仇恨
counteract	 v.  消除， 抵消
ample	 adj.  丰富的， 充足的
soar	 v.  高飞； 猛增， 剧增
debilitate	 v.  使衰弱
commute	 v.  坐公交车往返于两地； 变换； 交换
pretax	 adj.  税前的
sustain	 v.  支持， 维持； 遭受
classify	 v.  分类； 归类
altitude	 n.  高度
ease	 v. 缓和； n.  不费力
ethnographic	 adj.  人种学的， 人种论的
substitution	 n.  代替； 替代物
certitude	 n.  确定无疑
overrun	 n.  泛滥， 超出限度
critical	 adj.  挑毛病的； 关键的； 危急的
reactor	 n.  起反应的人； 【原】反应堆
stipend	 n.  薪水； 定期津贴
envision	 v.  想像
radiant	 adj.  辐射的； 发光的； 容光焕发的
sporadically	 adv.  偶发地； 零星地
penetrate	 v.  穿透， 渗透
homogeneity	 n.  同种， 同质
principal	 adj. 主要的； n.  校长
comedian	 n.  喜剧演员
exceedingly	 adv.  极端地， 非常
specimen	 n.  样品； 标本
letup	 n.  停顿
exotic	 adj.  外来的； 异乎寻常的
newlywed	 n.  新婚的人
carcinogenic	 adj.  致癌的； 致癌物的
boycott	 v&n.  联合抵制
dimension	 n.  尺度； 维； 方面
spiteful	 adj.  怀恨的， 恶意的
deserve	 v.  应受， 值得
process	 v.  处理， 加工； 列队前进 n.  过程， 进行； 步骤
artisan	 n.  手工业工人， 手艺人
restore	 v.  恢复； 重建
subscribe	 v.  订阅
distill	 v.  蒸馏； 提取
therapy	 n.  治疗， 疗法
alternative	 adj. 轮流的，交替的；两者择一的； n.  二中择一； 供替代的选择
paltry	 adj.  无价值的， 微不足道的
concentration	 n.  专心， 专注； 集中； 浓度
velocity	 n.  速度； 速率
encounter	 v. 偶然碰到，遭遇； n.  意外相见
prairie	 n.  大草原
ultrasound	 n.  超声
preflight	 adj.  起飞前的
duplication	 n.  复制； 副本
disinclined	 adj.  不愿的
agrarian	 adj.  土地的； 农业的
sinus	 n.  穴； 【解】 窦
approve	 v.  赞成； 批准， 认可
interaction	 n.  相互作用； 互动
pedestrian	 n.  行人
interfere	 v.  干涉， 妨碍
attendance	 n.  出席， 到场； 出席人数
regionalization	 n.  分成地区； 按地区安排
calefaction	 n.  加热； 发暖作用
intangible	 adj.  无形的， 难以确定的
radioactive	 adj.  放射性的， 有辐射能力的
causative	 adj.  成为原因的
underline	 v.  强调， 加强 n. 下划线；
resent	 v.  怨恨， 恼火
compassion	 n.  同情， 怜悯
stunning	 adj.  极富魅力的
parliament	 n.  国会， 议会
ambiguous	 adj.  意义不明的， 模棱两可的
allay	 v.  减轻， 缓和
crack	 v.  裂开， 断裂 n. 强效纯可卡因；
bind	 v.  捆绑； 结合； 约束
stimulant	 n.  刺激物； 兴奋剂
stimuli	 n.  刺激； 刺激物， 促进因素
interdependence	 n.  互相依赖
qualitative	 adj.  质的， 质量的； 定性的
diverse	 adj.  不同的， 多种多样的
cube	 n.  立方体
rally	 n.  跌后复升， 反弹
announcement	 n.  宣告； 公告， 通告
synchronize	 v.  使同步
clot	 v.  使凝结成块 n. 凝块；
memoir	 n. 传略，实录
impact	 n.  碰撞； 影响
profile	 n.  剖面； 轮廓； 分布图
preference	 n.  偏爱， 倾向； 优先权
mainstream	 n.  主流； 主要倾向
scavenge	 v.  清除； 从废物中提取有用物质
paralysis	 n.  瘫痪； 麻痹
stiffness	 n.  僵硬； 顽固
distort	 v.  弄歪； 歪曲
subsidiary	 adj.  附属的 n. 子公司；
venture	 v. 冒险； n.  企业； 冒险事业
clog	 v.  妨碍； 阻塞
population	 n.  人口； 生物种群
bucket	 v.  颠簸前进 n. 桶；一桶的量；
corrosive	 adj.  腐蚀性的， 蚀坏的
dose	 n.   剂量； 一服
discern	 v.  识别， 辨认
flexible	 adj.  易弯曲的， 灵活的
census	 n.  人口调查， 人口普查
domain	 n.  领地， 领土
smear	 v.  涂抹； 弄脏
secluded	 adj.  隐居的； 隐蔽的
relative	 adj.  相对的； 相关的 n. 亲戚；
amenable	 adj.  顺从的； 易作出响应的 ； 可按照…处理的
subgroup	 n.  小群； 隶属的小组织
depict	 v.  刻画， 描述
perennial	 adj. 长期的； n.  多年生植物
typhoid	 adj.  伤寒的， 斑疹伤寒症的 n. 伤寒；
amenity	 n.  舒适； 方便设施
off-season	 adj.  淡季的 n. 淡季；
inflammatory	 adj.  煽动性的； 发炎的
linkage	 n.  连接； 结合
interloper	 n.  闯入者
interior	 n&a.  内部
mint	 v.  铸造
embryonic	 adj.  胚胎的； 萌芽期的
lymph	 n.  淋巴
adoption	 n.  采用， 采纳； 收养
involvement	 n.  参与； 牵扯， 卷入
harmonize	 v.  和谐， 协调
distinctive	 adj.  出众的， 有特色的
prefigure	 v.  预示
composition	 n.  作文； 作曲； 构成
comet	 n.  彗星
epicenter	 n.  震中
acquisition	 n.  获得物
latch	 n.  门锁
rigid	 adj.  严格的； 死板的
replicate	 v. 复制，重复； n.  复制品
Confucian	 a&n.  孔子的； 儒家的； 儒家学者
chip	 n.  芯片； 碎片
migraine	 n.  周期性偏头痛
reverence	 n.  尊敬， 崇敬
emergence	 n.  出现， 浮现； 露头
advent	 n.  到来， 出现
medieval	 adj.  中世纪的， 中古的
assemble	 v.  集合； 装配
elude	 v.  逃避
transition	 n.  过渡， 转变
blast	 n.  爆炸
countervail	 v.  补偿； 对抗， 抵消
underscore	 v.  强调
bylaw	 n.  地方法规； 规章制度
supersede	 v.  替代， 取代
cultivate	 v.  种植； 向…讨好
diversification	 n.  多样化， 变化
thrive	 v.  兴旺； 茁壮生长
analytic	 adj.  分析的
dialect	 n.  方言， 语调
archaeologist	 n.  考古学家
rigor	 n.  严酷； 严格； 严密
accountant	 n.  会计人员， 会计师
emergency	 n.  紧急情况， 紧急事件
recreational	 adj.  娱乐的
dramatize	 v.  戏剧化
bulge	 v.  膨胀； 凸出
exemplary	 adj.  榜样的， 模范的
faculty	 n.  全体教员； 系； 才能
absurd	 adj.  荒唐的
limestone	 n.  石灰石
porpoise	 n.  海豚
airliner	 n.  班机； 大型客机
trait	 n.  特征； 特性
meteorite	 n.  陨星， 流星
molten	 adj.  熔融的， 熔化的
radius	 n.  半径
disintegration	 n.  分解； 瓦解
vanish	 v.  消失
reconvene	 v.  再集会
emancipation	 n.  解放， 释放
dedicated	 adj.  专注的； 献身的
stray	 v. 偏离，迷路； adj.  迷了路的； 偶然发生的
static	 adj.  不变的； 停滞的
upstream	 adv. 向上游； adj.  位于上游的
prerequisite	 n.  先决 条件， 前提
exhaust	 v. 用尽； n.  废气
thereafter	 adv.  此后
bring about	 引起；使掉头
conviction	 n.  判罪； 坚信
diversify	 v.  使多样化
bioengineer	 v. 生物工程制成； n.  生物工程师
graph	 n.  图表， 坐标图
sensitize	 v.  敏感
liberalize	 v.  使自由化； 宽大； 自由化
sodium	 n.  【化】 钠
relativity	 n.  相对论
legitimation	 n.  合法化； 承认为嫡出
undercapitalize	 v.  投资不足
inoculate	 v.  接种； 给…预防注射
excerpt	 n.  摘录， 选录
hexagonal	 adj.  六角形的； 六边形的
influenza	 n.  流行性感冒
divisive	 adj.  分裂的， 不和的
auditorium	 n.  礼堂； 观众席
analytical	 adj.  分析的
individualism	 n.  利己主义， 个人主义
tactile	 adj.  触觉的
session	 n.  会议； 集会
ovulate	 v.  排卵， 产卵
introductory	 adj.  引导的； 介绍的
apiece	 adv.  每个， 每人， 各
complainant	 n.  控诉者； 原告
samurai	 n. 武士；
hone	 v.  用磨刀石磨； 磨练
spoilage	 n.  损坏； 损坏物
duration	 n.  持续， 持久
accretion	 n.  增长； 增加物
plantation	 n.  栽植
egoistic	 adj.  自我主义的， 利己主义的
alpha	 n.  希腊语字母表的第一个字母
rudder	 n.  船舵
corroborate	 v.  证实
herbicide	 n.  除草剂
contraction	 n.  收缩
amalgam	 n.  混合物
bland	 adj.  温和的； 乏味的
loaf	 n. 〔面包的〕一条 v. 虚度光阴；闲荡
microbe	 n.  微生物； 病菌
reception	 n.   接收效果
carbonate	 n.  碳酸盐
nuclear	 adj.  核心的； 核子的， 原子能的
aerodynamic	 adj.  空气动力学的
potter	 n.  陶工
lunar	 adj.  月球的， 有关月球的
lumber	 n.  木材
relay	 v.  中继转发， 转播
priest	 n.  牧师， 神父
monitor	 v. 监控； n.  班长
tuition	 n.  学费
reflex	 n.  反应； [～es]反应能力
permeate	 v.  扩散； 渗透
tangible	 adj.  可触摸的； 切实的
insomnia	 n.  失眠
raccoon	 n.  浣熊
postage	 n.  邮资， 邮费
intestinal	 adj.  肠的
rewind	 v.  重绕； 倒带
deterioration	 n.  恶化； 退化； 堕落
faction	 n.  派系， 派别
spectacular	 adj.  壮观的， 壮丽的
overwhelming	 adj.  压倒性的； 势不可挡的
inherit	 v.  遗传； 继承
peculiar	 adj.  独特的， 特殊的
hue	 n.  颜色， 色彩
recoup	 v.  补偿； 恢复
grant	 v. 同意，认可；允许；提供，授予； n.  补助
hypertension	 n.  高血压； 过度紧张
injection	 n.  注射； 注射剂  that is injected)
hum	 v.  哼， 发出嗡嗡声
ransom	 v.  救赎 n. 赎金；
staple	 adj.  主要的 n. 主要产品，主要成分；
cylindrical	 adj.  圆柱体的； 圆筒形的
relic	 n.  文物
paleontologist	 n.  古生物学家
unionist	 n.  工会会员； 联合主义者
bellows	 n.  风箱
discount	 v.  忽视； 打折 n.  折扣
chatty	 adj.  喜欢唠叨的； 话题轻松的
convert	 v.  转化， 改变； 换算
construct	 v.  建筑， 建造； 构成
royalty	 n.  皇室； 版税， 专利税
attempt	 v.  试图， 尝试 n. 企图，尝试；
collaborate	 v.  协作； 勾结， 通敌
rivalry	 n.  竞争， 对抗
fluorescent	 adj.  荧光的
sinew	 n.  腱； 肌肉
division	 n.  部门； 分裂； 区分
superficial	 adj.  肤浅的； 粗略的
ethnomusicology	 n.  人种音乐学
executive	 adj.  行政的； 经营管理的 n. 执行者；
foreclosure	 n.  取消抵押品赎回权
navigation	 n.  航行， 航海； 导航
stinger	 n.  刺； 讽刺者； 鸡尾酒
mimic	 v.  模仿， 效仿
loch	 n.  湖； 狭长的海湾
casualty	 n. 伤亡；
spatial	 adj.  空间的
inspection	 n.  检查； 视察
gauge	 v.  测量(to measure)； 判断(to judge) n. 标准规格accordingtosomestandardorsystem)；量具(aninstrumentforameansofmeasuringortesting)；
varsity	 n.  大学； 大学代表队
meld	 v.  混合， 合并
bounty	 n.  奖金， 赏金
studious	 adj.  慎重的； 有意的
ridicule	 n&v.  嘲笑， 嘲弄
sensitive	 adj.  敏感的； 易波动的
brew	 v.  酿造； 冲泡
hoof	 v.  用蹄踢； 步行 n. 蹄；
vacant	 adj.  空着的， 未占用的
detached	 adj.  不含个人偏见的
snuff	 v. 吸； n.  鼻烟
debunk	 v.  揭穿真相； 暴露
lobe	 n.  叶
irate	 adj.  生气的， 愤怒的
virtuous	 adj.  有道德的， 品性好的
deflect	 v.  偏斜， 转向
wilderness	 n.  荒地； 茫茫一片
interval	 n.  间隔， 间距
legitimate	 adj.  合法的； 正当的
impede	 v.  妨碍， 阻碍
evaluate	 v.  评价； 估计
status	 n.  身份； 地位； 状况
renown	 n.  名望， 声誉
shield	 v.  保护； 挡开 n. 盾；保护物；
anatomy	 n.  解剖； 解剖学
embarrassed	 adj.  尴尬的； 窘迫的
extraneous	 adj.  无关的； 外来的
deliver	 v.  交付； 递送； 实现
instantaneous	 adj.  即时的
disseminate	 v.  传播， 散布
phenomenon	 n.  现象； 奇迹
notify	 v.  通知， 报告
exodus	 n.  离开， 移居
malfunction	 v. 失灵，发生故障； n.  故障
file	 v.  提出申请 n. 文件；档案；
cult	 n.  崇拜
buoyant	 adj.  有浮力的； 快乐的
recur	 v.  再发生； 重新提起
accumulate	 v.  积累； 堆积
pristine	 adj.  原始的； 未被破坏的； 纯洁的； 新鲜的
coalition	 n.  结合， 联合
dwarf	 v.  变矮小 n. 矮子；
affirmative	 adj. 肯定的； n.  肯定语
nematode	 n.  线虫类
paleozoologist	 n.  古动物学家
allege	 v.  断言， 宣称
cutback	 n.  减少， 削减
irregularity	 n.  不规则； 无规律； 不整齐
amber	 n.  琥珀
entrepreneurship	 n.  企业家精神
trigger	 v.  引发， 导致 n. 扳机；
conservatively	 adv.  保守地
positive	 adj.  肯定的； 积极的； 【数】 正的
segregate	 v.  隔离； 分开
cultivation	 n.  教化； 耕种
computation	 n.  计算， 估计
rental	 adj.  租赁的 n. 租金；租赁；
addict	 v.  使上瘾， 使入迷 to something habitually or obsessively) n.  有瘾的人
prospect	 n.  前景； 期望
virtuoso	 n.  演艺精湛的人
refugee	 n.  难民
kinetic	 adj.  运动的
comparable	 adj.  可比较的； 比得上的
specialize	 v.  专门从事
residency	 n.  住宅， 住所； 住院医生实习期
rotate	 v.  旋转； 轮作
conscience	 n.  良心， 是非感
bonus	 n.  奖金， 红利
subject	 adj. 受制于…的； n.  国民； 主题； 科目
convoluted	 adj.  错综复杂的
engulf	 v.  吞噬
integer	 n.  整数
reptile	 n.  爬行动物
receptive	 adj.  接受的
personhood	 n.  做人； 人格
endorphin	 n.  【生化】  内啡肽
sugarcane	 n.  甘蔗
anaerobic	 adj.  厌氧的
revenue	 n.  收入； 税收
sufficiency	 n.  足量， 充足
strip	 v. 剥去； n.  狭长的一片
geographic	 adj.  地理的； 地理学的
monopoly	 n.  垄断； 专利权
diverge	 v.  偏离； 离题
negotiation	 n.  谈判； 协商
accelerate	 v.  加速， 促进
credit	 v.  把…归给； 把…记入贷方 n. 信用，信任；
spate	 n.  大批， 大量
intensive	 adj.  加强的； 集中的
combine	 v.  联合， 结合
alter	 v.  改变， 变更
divisible	 adj.  可分割的； 可整除的
illustrate	 v.  举例说明
regressive	 adj.  递减的
scuba	 n.  水肺； 水中呼吸器
irreconcilable	 adj.  矛盾的， 不能协调的
definitive	 adj.  确定的； 权威性的
avidly	 adv.  渴望地， 热心地
nomad	 n.  流浪者； 游牧部落的人
undesirable	 adj.  令人不悦的， 讨厌的
literacy	 n.  识字； 有文化
originate	 v.  出现； 开始
martial	 adj.  军事的
infer	 v.  推论， 推断
specialist	 adj.  专业的 n. 专家；
transit	 n.  运输， 载运
adolescent	 adj.  青春期的 n. 青少年；
dispose	 v.  处置； 安排
curtail	 v.  缩减
oriented	 adj.  导向的
sentiment	 n.  多愁善感； 思想感情
strife	 n.  纷争， 冲突
nexus	 n.  关系， 连结
differentiation	 n.  变异； 分化； 区别
sheath	 n.  鞘 )； 防护物(sheathing)
patent	 v.  取得…的专利 n. 专利权；
amino acid	 n.  氨基酸， 胺酸
pollen	 n.  花粉
cocaine	 n.  可卡因
paradigm	 n.  范例， 示范
groove	 n.  凹线； 线条； 习惯
certificate	 n.  证券； 证明书
quantum	 n. 量子
conceive	 v.  怀孕； 构思， 设想
incandescent	 adj.  白炽的； 遇热发光的
incursion	 n.  侵犯， 入侵
predate	 v.  居先， 早于
transform	 v.  使…变形； 改变
overpayment	 n.  多付的款额
paradox	 n.  似非而是的说法； 自相矛盾的人
manic	 adj. 狂躁的； n.  狂躁者
magnitude	 n.  重要性； 长度； 震级
genuine	 adj.  真正的
singularly	 adv.  异常地； 特别地
repeal	 v.  【律】 废除， 撤销
gorilla	 n.  大猩猩
brochure	 n.  小册子； 说明书
immune	 adj.  免疫的
deviation	 n.  背离
gentry	 n.  贵族， 绅士， 上等人
compound	 adj.  混合的 n. 混合物，化合物；
underlie	 v.  位于…之下； 成为…的基础或依据
stake	 n.  火刑柱； 股份
intensity	 n.  强度； 紧张
masculine	 adj.  男性的； 男子气概的
extraordinary	 adj.  非凡的， 特别的； 离奇的
concerning	 prep.  关于； 就…而言
attraction	 n.  吸引， 吸引力
fortify	 v.  增强营养
spawn	 v.  大量产生； 引起 n. 卵；
conventional	 adj.  因循守旧的； 传统的
privy	 adj.  私人的； 不公开的， 秘密参与的 n. 有利害关系的人；
conform	 v.   遵照； 符合
circulation	 n.  循环， 流通； 发行额
authentic	 adj.  真正的； 法律证实的
evident	 adj.  明显的， 清楚的
lodge	 n.  房子， 住处
measles	 n.  麻疹
devoid	 adj.  空的， 缺乏的
psychological	 adj.  心理学的； 心理的， 精神的
commit	 v.  做； 犯； 交付； 受约束， 致力于
patriarchal	 adj.  家长的， 族长的
originality	 n.  创意， 独创性
empirical	 adj.  经验主义的， 经验的
particulate	 adj.  微粒的 n. 微粒，粒子；
curb	 v.  控制 n. 路边；
outpatient	 n.  门诊病人
envelop	 v.  笼罩， 包住
patch	 v. 缝补；修补； n.  斑点
predicate	 v.  使基于； 断言， 肯定； 暗示
precipitation	 n.  沉淀； 沉淀物
character	 n.  性格； 特征； 字符
ongoing	 adj.  进行中的， 不间断的
outfit	 v.  配备， 装备
supernova	 n.  【天】 超新星
constellation	 n.  星座， 星群
divulge	 v.  泄漏
cholesterol	 n.  胆固醇
crass	 adj.  粗劣的； 愚钝的
runner	 n.  蔓藤； 推销员； 长跑者
respiratory	 adj.  呼吸的
negligible	 adj.  可忽略不计的； 微不足道的
moderate	 v.  减轻； 节制 adj.  温和的； 适度的
comprise	 v.  包含； 组成
proton	 n.  质子
upheaval	 n.  大变动
brokerage	 n.  经纪业， 中间人业务； 佣金， 回扣
spray	 v.  喷洒 n. 喷雾；小花枝；
distinguish	 v.  区别， 辨清； 杰出
primordial	 adj.  原始的； 主要的
intersperse	 v.  散布
matriarch	 n.  女统治者， 女负责人； 女家长
howl	 v&n.  嗥叫； 呼啸
substantial	 adj.  实际的； 大量的
execute	 v.  执行； 制成
dissimilar	 adj.  不同的， 不相似的
benefit	 v.  有益于， 对…有益 n. 利益，好处；救济金；
refuel	 v.  补给燃料； 重新得到燃料
booth	 n.  小房间
elongate	 v.  延长， 伸长
symptom	 n.  征兆； 症状
illicit	 adj.  违法的， 不正当的
nihilism	 n.  虚无主义
wield	 v.  支配， 掌握
unique	 adj.  唯一的； 独特的
boost	 v&n.  推， 举； 促进； 吹捧
impulse	 n.  冲动； 脉冲
mechanization	 n.  机械化， 机动化
crystallize	 v.  结晶； 具体化
maternal	 adj.  母亲的； 母方的； 母系的
infectious	 adj.  传染性的， 易传染的
religious	 adj.  宗教的； 虔诚的
shelter	 v.  庇护， 保护 n. 躲避处；
jumbo	 adj.  巨大的
prominent	 adj.  显著的； 杰出的
superiority	 n.  优越
insulin	 n.  胰岛素
ironic	 adj.  说反话的， 讽刺的
latitude	 n.  纬度； 自由
association	 n.  协会， 联盟； 联想
eliminate	 v.  排除， 消除
parasitic	 adj.  寄生的
landfill	 n.  垃圾堆； 垃圾填埋法
entitle	 v.  命名； 有权
outline	 v.  描画轮廓； 概括 n. 轮廓；概述；
purification	 n.  净化， 提纯
butterfly	 n.  蝴蝶； 追求享乐的人
outnumber	 v.  在数量上超过
identifiable	 adj.  可辨认的
perspective	 n.  角度， 观点
womb	 n.  子宫； 孕育处, the organ in which offspring is carried and nourished while it develops before birth)
galaxy	 n.  银河， 星系
overlord	 n.  最高领主
warbler	 n.  鸣禽
redirect	 v.  改寄； 改变方向
liquidation	 n.  清算
prosper	 v.  兴隆； 成功
invade	 v.  侵略， 侵袭
propeller	 n.  螺旋桨， 推进器
dogma	 n.  教条
perpetrator	 n.  作恶者； 犯罪者
clump	 v.  使密集 n. 丛，簇；
drilling	 n.  钻孔； 训练， 演练
appeal	 v.  吸引； 上诉 n. 呼吁；吸引力；
crate	 n.  篮， 篓
cardiovascular	 adj.  心血管的
prognosis	 n.  预后
entrepreneur	 n.  企业家； 承包人
democracy	 n.  民主， 民主主义； 民主政治
transportation	 n.  运输， 运输系统； 流放
peninsula	 n.  半岛
evolve	 v.  进化； 逐渐形成
dye	 v.  给…染色 n. 染料；
extensive	 adj.  大量的； 多方面的， 广泛的
residential	 adj.  住宅的， 与居住有关的
cessation	 n.  停止
household	 adj.  普通的； 家庭的 n. 家庭；
adverse	 adj.  逆的； 不利的
ratio	 n.  比例
barb	 v.  装倒钩于 n. 倒钩；伤人的话；
circumvent	 v.  环绕； 回避， 规避
alumnus	 n.  男校友， 男毕业生
entrant	 n.  进入者； 新成员
gourmet	 n.  美食家
approximate	 v.  接近 adj.  近似的， 大概的
cannon	 n.  加农炮， 大炮
project	 v.  预计 n.  工程； 计划
chronology	 n.  年表； 年代学
independence	 n.  独立性， 自立性； 自主
lateral	 adj.  侧生的， 侧的
irradiation	 n.  放射， 照射
shrub	 n.  灌木
melancholy	 adj.  忧郁的
presentation	 n.  报告； 陈述
hinterland	 n.  内地； 穷乡僻壤
nominate	 v.  提名
loom	 v. 隐现； n.  织布机
diameter	 n.  直径
stationary	 adj.  静止的
inextricably	 adv.  无法分开地
swiftly	 adv.  很快地， 即刻
bark	 n.  树皮
ostentation	 n.  夸示， 炫耀
roughly	 adv.  大概； 粗暴地
restrain	 v.  抑制； 限制； 阻止
exhaustive	 adj.  详尽的， 无遗漏的
monumental	 adj.  极大的； 纪念碑的
ruin	 v.  毁灭； 破产
leaven	 v.  发酵
formidable	 adj.  可怕的； 困难的
durability	 n.  经久， 耐久性
lobster	 n.  龙虾
modification	 n.  修正， 修改
nucleon	 n.  核子
anemia	 n.  贫血； 贫血症
folkway	 n.  民风， 社会习俗
dense	 adj.  密集的； 浓厚的)
discrete	 adj.  个别的； 不连续的
temperate	 adj.   温和的； 有节制的
disrupt	 v.  扰乱； 中断， 瓦解
geometric	 adj.  几何的； 成几何级数增长的
campaign	 n.  战役； 系列活动
salvage	 v. 抢救； n.  抢救出的财物
overfish	 v.  过度捕捞  or to the depletion of )
conflict	 n.  斗争， 冲突， 抵触
scandalize	 v.  使震惊； 诽谤
appliance	 n.  用具， 用品
lore	 n.  知识； 学问
mass	 v. 使集合； n.  大量； 【物】 质量； 大量
companionate	 adj.  伙伴的； 和睦的
renaissance	 n.  复兴， 复活； 文艺复兴
amateur	 n.  业余爱好者
derivative	 adj. 派生的；无创意的； n.  转成物
condemn	 v.  声讨， 谴责
commerce	 n.  贸易， 商业
auction	 n.  拍卖
admit	 v.  承认； 准许…进入
mineralize	 v.  使矿物化  into an ore)
uneven	 adj.  不规则的； 不平坦的； 不均匀的
definition	 n.  定义
tectonics	 n.  构造学； 地质构造
unaffected	 adj.  自然的， 不矫揉造作的
evacuation	 n.  撤离， 疏散
patrol	 v&n.  巡逻， 巡查
offshoot	 n.  分支
patron	 n.  赞助者； 顾客
canary	 n.  金丝雀； 女歌星
antedate	 v.  早于， 先于
entail	 v.  伴随；  承担
stew	 v.  炖 n. 炖菜；
inferior	 adj.  次的， 较差的
mythic	 adj.  虚构的； 神话的
overlook	 v.  忽略， 忽视
taxpayer	 n.  纳税人
spine	 n.  脊柱； 刺
commend	 v.  推荐； 表扬
seedling	 n.  幼苗； 树苗
scribe	 v.  抄写 n. 抄写员；
mosquito	 n.  蚊子
parasite	 n.  寄生虫； 食客
artificial	 adj.  人工的， 人造的
deficiency	 n.  缺陷； 不足
urbanize	 v.  使…都市化
defrost	 v.  除霜； 解冻
campsite	 n.  营地
formula	 n.  公式
avalanche	 v.  雪崩 n. 雪崩；
comment	 v.  发表评论 n. 评论，意见；
passbook	 n.  存折
temperance	 n.  节欲； 禁酒
tribute	 n.  礼物， 贡品
endanger	 v.  危及， 危害
stem	 v.  起源于； 阻断 n. 茎，干；
euphoria	 n.  精神欢快； 兴奋
surcharge	 n.  附加税； 额外费
oblique	 adj.  斜的， 倾斜的
profitability	 n.  赢利能力， 收益性
transnational	 adj.  跨国的； 超越国界的
subordinate	 adj. 下级的； n.  下级
versatility	 n.  多功能性
sturdy	 adj.  结实的； 坚固的
equalize	 v.  平衡， 相等
reasoning	 adj.  推理的 n. 推理，论证；
pugnacious	 adj.  好斗的
ragtime	 adj.  滑稽的 n. 拉格泰姆音乐；
revolution	 n.  革命； 旋转
balcony	 n.  阳台； 包厢， 楼座
instill	 v.  逐渐灌输
polygraph	 n.  测谎器
ingest	 v.  咽下， 吸收
reliable	 adj.  可靠的， 可信赖的
palatable	 adj.  美味的； 受欢迎的
compatible	 adj.  协调的； 兼容的
incentive	 n.  刺激； 动机
critic	 n.  评论家， 批评家
mow	 v.  割
deregulation	 n.  违反规定， 撤销管制规定
photosynthesis	 n.  光合作用
repudiate	 v.  拒绝； 拒付
preliminary	 adj.  预备的； 初步的， 开始的
decoration	 n.  装饰， 装潢； 装饰品； 奖章
mishap	 n.  不幸， 坏运气
obstacle	 n.  障碍
industrialization	 n.  工业化
crest	 n.  顶部
unconstitutional	 adj.  违反宪法的
fickle	 adj.  易变的， 不坚定的
provisional	 adj.  暂时的， 临时的
compress	 v.  压缩， 浓缩
exceptional	 adj.  例外的， 罕见的； 杰出的
constitute	 v.  组成， 建立； 制定
ornamentation	 n.  装饰物； 装饰
benchmark	 v.  标准测试 n. 基准；
eminent	 adj.  杰出的； 突出的
resistance	 n.  抵抗； 抵抗力； 阻力
inequality	 n.  不平等， 不平均； 不同
discrepancy	 n.  差异； 矛盾
courier	 n.  送急件的人
spectrum	 n.  范围； 光谱 so that its component wavelengths are arranged in order)
convince	 v.  某人确信； 说服
disorient	 v.  使迷惑； 使分不清方向或目标
irritating	 adj.  刺激的； 使人愤怒的， 气人的
dropout	 n.  <美>中途退学
fibrosis	 n.  纤维化
terminate	 v.  停止， 终止； 解雇
antiquated	 adj.  过时的
mannerism	 n.  特殊习惯， 怪癖
refund	 n.  退款； 偿还
remnant	 n.  残余物， 残迹
contractor	 n.  承包人； 立契约者
flock	 n.  一群
diesel	 n.  内燃机， 柴油机
deprecate	 v.  反对； 藐视
steep	 adj. 极高的； v.  沉浸； 充满
signature	 n.  签名， 签字
republican	 adj.  共和国的 n. 共和主义者；
architect	 n.  建筑师， 设计师
perversion	 n.  曲解， 颠倒
privilege	 n.  特权； 优惠
shroud	 n.  裹尸布； 覆盖物
dumpster	 n.  垃圾桶
substitute	 v.  代替， 替代 n. 代替品；
gimmick	 n.  伎俩， 噱头
per capita	 adj.  每人， 照人数分配的
uniform	 adj.  统一的； 相同的 n. 制服；
amplitude	 n.  广度； 振幅
mortgage	 v.  抵押 n. 抵押贷款；
falsify	 v.  篡改； 说谎
identity	 n.  身份， 特征； 同一
installation	 n.  安装； 装置
scatter	 v.  分散， 散开
maldistribution	 n.  分配不当
federal	 adj.  联邦的， 联邦政府的
violate	 v.  违反， 违背
congregation	 n.  全体教徒
verify	 v.  证明， 证实
steer	 v.  掌舵 n. 肉用公牛；
collective	 adj.  集体的
excursion	 n.  远足， 短途旅行
undergo	 v.  经历， 经受； 忍受
spruce	 n.  云杉
outlying	 adj.  远离城市的， 边远的
delineate	 v.  描画； 描绘轮廓
bygone	 adj.  以前的； 过时的 n. 过去的事；
erase	 v.  擦掉， 抹去； 消除
coupon	 n.  赠券； 优待券
railroad	 n.  铁路
multitude	 n.  大量， 众多
hominid	 n&a.  原始人类； 灵长目动物
inhabit	 v.  居住于， 栖居于
countermeasure	 n.  对策， 对抗手段
innate	 adj.  天生的， 固有的
downstream	 adv.  顺流而下， 朝下游方向
siege	 n.  包围， 围攻
nucleus	 n. (原子)核
sting	 v. 蜇，叮； n.  螫伤
abstract	 adj. 抽象的； n.  摘要
skeptic	 n.  怀疑者
alluvial	 adj.  冲积的， 淤积的
quasar	 n.  【天】 类星体
paternity	 n.  父权； 父系， 父系后裔
anonymous	 adj.  匿名的
span	 n.  跨度； 一段时间
imbalance	 n.  不平衡； 不安定
bizarre	 adj.  奇异的， 古怪的
astronomical	 adj.  庞大的； 天文学的
fertility	 n.  繁殖力； 丰产
ascribe	 v.  归于， 归因于
threshold	 n.  门槛； 开端， 起点
termite	 n.  【昆】白蚁
poll	 n.  民意测验
minority	 n.  少数民族， 少数
stringent	 adj.  严格的； 严厉的
avian	 adj.  鸟类的 n. 鸟；
chamber	 adj.  【音】 室内的 n. 室，房间；
rangeland	 n.  牧场
portfolio	 n.  文件夹； 投资组合
defendant	 adj.  为自己辩护的 n. 被告；
evade	 v.  躲开； 逃避
segregation	 n.  隔离， 分离
depart	 v.  背离， 违反； 出发
exaggerate	 v.  夸张， 夸大
cortex	 n.  皮质
exploration	 n.  探索， 探测
imply	 v.  暗示， 暗指
offset	 v.  抵销； 补偿
parlor	 n.  会客室； 店堂； 餐车
cascade	 n.  小瀑布
commitment	 n.  承诺， 许诺
capture	 v.  捕捉； 占领； 吸引， 赢得
partridge	 n.  鹧鸪； 松鸡
fossil	 n.  化石
procreative	 adj.  生育的
rejection	 n.  抛弃； 拒绝； 被抛弃的东西
disciple	 n.  门徒， 弟子
fixture	 n. 〔预定举行的〕体育比赛
sequence	 n.  顺序； 序列
manufacture	 v.  生产
extrapolation	 n.  推断， 推知
combustion	 n.  燃烧
arthritis	 n.  关节炎
recruit	 v.  招收 n. 新成员；
provision	 n.  供应； 条款
doctorate	 n.  博士学位
permissive	 adj.  许可的； 过分纵容的
predicament	 n.  困境， 窘境
intervention	 n.  干涉， 介入
replacement	 n.  更换； 代替者
tract	 n.  一片； 【解】 管道
incineration	 n.  焚烧
configuration	 n.  构造； 外形； 【天】 相对位置
nonstarter	 n.  毫无成功希望的人
spherical	 adj.  球的， 球状的
interact	 v.  相互作用； 相互配合
bombard	 v. 炮轰，射击； n.  射石炮
outright	 adv.  直率地； 全部地， 彻底地
bestow	 v.  放置； 授予
platform	 n.  平台
asteroid	 n.  小行星
commonplace	 adj. 平凡的，普通的； n.  平庸的东西， 陈词滥调
aggregate	 v. 合计； adj.  合计的， 聚合的 n. 集合体；
captivate	 v.  迷住， 迷惑， 吸引
provenance	 n.  出处， 起源
nonbiodegradable	 adj.  不能生物降解的
disdainful	 adj.  轻蔑的， 鄙视的
pneumonia	 n.  肺炎
array	 v. 排列； n.  大批
extinct	 adj.  灭绝的； 熄灭的
pneumonic	 adj.  肺的； 肺炎的
discriminate	 v.  歧视； 辨别
accompaniment	 n.  伴奏
degrade	 n.  降低…的身份； 降解； 退化
procure	 v.  取得， 获得
opaque	 adj.  不透明的； 难懂的
criminology	 n.  犯罪学
refutation	 n.  反驳， 驳斥
humid	 adj.  潮湿的， 湿润的
controversy	 n.  争论， 辩论
ineffective	 adj.  无效的
shellfish	 n.  甲壳类动物
compulsory	 adj.  强制性的； 义务的
performance	 n.  性能； 表演； 成绩， 绩效
round	 v. 四舍五入；完成； adj. 圆的； n.  圆
anticipate	 v.  预见， 预期
variable	 n.  可变物； 变量， 变数
detach	 v.  分开， 分离
mass-transit	 n.  公共交通
misinterpret	 v.  误解
landscape	 n.  风景
vague	 adj.  模糊的， 含糊的
reversion	 n.  返回； 逆转
communist	 adj.  共产主义的 n. 共产党员，共产主义者；
temporary	 adj.  短暂的， 暂时的； 临时的
episodic	 adj.  偶然发生的； 分散性的
habitat	 n.  栖息地
optimal	 adj. 最佳的； n.  最大限度
resplendent	 adj.  灿烂的； 辉煌的
accuracy	 n.  准确， 精确
spouse	 n.  配偶， 夫妻
geological	 adj.  地质的
unleavened	 adj.  未经发酵的 made without yeast or other raising agent)
quote	 v.  引用， 引述 from another usually with credit acknowledgment)
refraction	 n.  折射
silkworm	 n.  蚕， 桑蚕
quota	 n.  限额， 配额
thermal	 adj.  热的， 热量的
scorn	 v&n.  轻蔑； 嘲笑
visual	 adj.  看得见的； 视觉的
diagnostic	 adj. 诊断的，判断的； n.  诊断程序
hypnotize	 v.  对…施催眠术
terrain	 n.  地势， 地形
sanctuary	 n.  圣堂； 避难所； 鸟兽禁猎区
adapter	 n.  适应者； 适配器
instruct	 v.  指示； 教育， 指导
merchant	 n.  商人
proportional	 adj.  成比例的； 均衡的
economy	 adj.  经济的 n. 经济；节约；
ailment	 n.  疾病
community	 n.  团体； 共同体
version	 n.  译本； 版本
dealership	 n.  代理商， 经销商
capitalize	 v.  资本化； 获利； 利用
bronze	 n.  青铜
staunch	 adj.  坚定的； 忠诚的
municipal	 adj.  市的； 市政的
institute	 v. 制定，创立； n.  学院， 协会
better-off	 adj.  境况较好或较富裕
feign	 v.  假装， 伪装
exhale	 v.  呼出， 呼气
appropriate	 adj.  适当的， 相称的
connotation	 n.  言外之意， 内涵
providing	 conj.  假如； 以…为条件
interest rate	 n. 〔贷款或存款的〕利率，利息率
criterion	 n.  评判的标准， 尺度
financier	 v.  对…提供资金 n. 金融家；
primer	 n.  识字课本； 底漆， 首涂油， 打底剂
essence	 n.  本质； 精华
manual	 adj.  手工的
matrix	 n.  模型； 母体
interstate	 adj. 洲际的； n.  美洲际公路
backwater	 n.  回水； 死水
maneuver	 n&v.  操纵， 管理
eloquent	 adj.  雄辩的
observatory	 n.  天文台
proponent	 n.  拥护者， 倡导者
submarine	 n.  潜艇
scrubber	 n.  刷子； 净气器
cupidity	 n.  贪婪， 贪心
aspect	 n.  方面； 面貌， 外表
vegetarian	 adj.  素食的 n. 素食者；
particle	 n.  极少量； 微粒
aggressive	 adj.  好斗的； 进取的
naturalize	 v.  使入籍
descend	 v.  下降； 遗传
cultivated	 adj.  耕种的； 栽植的； 有修养的
mitigate	 v.  减轻
density	 n.  浓度， 密度
signify	 v.  表示， 意味着
unrefined	 adj.  未提炼的
onset	 n.  发作， 开始
rationale	 n.  根本性的依据
distributor	 n.  经销商； 分配器； 分配者
slam	 v.  猛烈撞击； 砰地关上
stunt	 v.  阻碍， 妨碍 n. 噱头；
turbulent	 adj.  骚乱的， 狂暴的
overt	 adj.  公开的， 非秘密的
refute	 v.  反驳， 驳倒
spin	 v.  快速旋转
severe	 adj.  严重的； 严厉的； 严酷的
emerge	 v.  浮现； 暴露
exemplify	 v.  是…的典型， 例示
irritant	 n.  刺激物
lease	 v.  出租， 租赁 n. 租约，租期；
collateral	 n.  抵押品， 担保
exploit	 v.  开发， 利用
characterization	 n.  描述
congestion	 n.  拥挤， 堵塞； 充血
cowhide	 n.  牛皮； 牛皮鞭
scout	 v.  侦察； 寻找 n. 侦察员；
register	 v.  登记 n. 登记簿；
scour	 v.  擦洗； 四处搜索
archenemy	 n.  天敌； 主要敌人
budworm	 n.  蚜虫
errand	 n.  差使
lethal	 adj.  致命的； 极其有害的
historical	 adj.  历史的， 史学的； 基于历史的
acclaim	 v. 欢呼；称赞； n.  欢呼； 称赞
disparaging	 adj.  贬低的， 轻蔑的
betrayal	 n.  背叛
stun	 v.  昏厥； 震惊
multicellular	 adj.  多细胞的
spring	 v.  跳； 出现 n. 泉；春天；
autonomy	 n.  自治； 自主
bifurcation	 n.  分歧
outmoded	 adj.  过时了的， 不再流行的
transmission	 n.  传递， 传送
negligence	 n.  疏忽， 粗心大意
offender	 n.  冒犯者； 违法者
dubious	 adj.  可疑的； 不确定的
intuition	 n.  直觉； 由直觉获知的信息
geophysical	 adj.  地球物理学的
ductile	 adj.  易变形的； 可塑的
bourgeois	 n.  资本家； 中产阶级的人
utensil	 n.  用具， 器皿
attributable	 adj.  可归于的
caste	 n.  社会等级制度； 社会团体
amend	 v.  修订； 改进
finite	 adj.  有限的； 【数】 有穷的
exquisite	 adj.  精致的； 近乎完美的
collide	 v.  碰撞； 抵触
propitious	 adj.  适合的， 有利于…的
remedy	 v.  补救； 纠正 n. 药；
interservice	 adj.  【军】 各军种间的
consent	 v.  同意， 答应
fusion	 n.  融合； 聚变
secretion	 n.  分泌； 分泌物
mutual	 adj.  相互的； 共同的
beneficiary	 n.  受益人， 受惠者
catalyst	 n.  催化剂； 促使事物发展的因素
carnivore	 n.  肉食动物
pharmacy	 n.  药房； 药剂学
preeminent	 adj.  卓越的， 杰出的
protestant	 n.  新教； 新教的
decimal	 adj.  小数的； 十进制的 n. 小数；
alignment	 n.  队列； 结盟
contiguous	 adj.  接近的， 接壤的
cynical	 adj.  愤世嫉俗的
culminate	 v.  达到顶点
benevolence	 n.  仁慈； 善行
unwarranted	 adj.  无根据的
beehive	 n.  蜂窝， 蜂箱
monarch	 n.  君主
strand	 n.  股， 缕
accomplish	 v.  完成， 做成功
constituent	 n.  成分； 要素； 选民
dislodge	 v.  逐出； 去除
havoc	 n.  大破坏， 浩劫
responsible	 adj.  承担责任的； 作为原因的
archaeology	 n.  考古学
enumerate	 v.  列举， 枚举
morale	 n.  士气
expatriate	 v. 移居国外； n.  移居国外的人
illuminate	 v.  照明； 说明
lizard	 n.  蜥蜴
periphery	 n.  外围
preoccupation	 n. 先入之见；； 入神
unequivocally	 adv.  不含糊地； 明确地
embrace	 v.  拥抱； 信奉； 接受
identify	 v.  识别， 鉴别
intersect	 v.  相交
nitrogen	 n.  氮
carpentry	 n.  木器； 木工手艺； [木]木工业
residue	 n.  剩余物； 残余
aquarium	 n.  水族馆； 养鱼池
significance	 n.  意义； 重要性
modify	 v.  修改， 更改
interpolation	 n.  插入； 【数】 内推法
pledge	 n&v.  保证； 许诺
progressive	 adj.  上进的； 【医】 愈来愈严重的
exempt	 v. 免除，豁免； adj.  被免除的
reservoir	 n.  水库； 蓄水池
deliberate	 adj.  深思熟虑的； 蓄意的
physiological	 adj.  生理的； 生理学上的
feminist	 n.  女权主义者
reproduction	 n.  再生产
atmosphere	 n.  大气； 气氛
decorate	 v.  装饰， 点缀
discretionary	 adj.  自由决定的； 可随意使用的
occupation	 n.  工作， 职业； 占领
carpeting	 n.  毛毯， 地毯
release	 v&n.  排放； 发表； 解放， 释放
charter	 v.  租； 给予特权 n. 宪章；租赁；
arithmetic	 n.  算术
hardy	 adj.  抵抗力强的
rib	 n.  肋骨； 【船】 肋材
boarder	 n.  寄膳者； 寄宿生
toll	 v.  敲 n. 过路费；伤亡人数，损失；
carbohydrate	 n.  碳水化合物， 糖类
variation	 n.  变化； 变异
apex	 n.  顶点， 最高点
moral	 adj.  道德的； 精神上的
diminution	 n.  减少， 缩减
eject	 v.  喷射； 驱逐
reinforce	 v.  加强； 补充
explode	 v.  爆炸， 炸开
rim	 n.  边； 轮辋
property	 n.  财产， 资产； 性质
debris	 n.  碎片， 残骸
rebut	 v.  反驳
delicacy	 n.  美味， 佳肴； 精妙
splotchy	 adj.  有污点的， 污渍斑斑的
manipulate	 v.  操纵， 操作
contradict	 v.  否定； 反驳
Catholic	 adj.  罗马天主教的
digitize	 v.  数字化  to digital form)
pathogenic	 adj.  【医】 病原的， 致病的
idiosyncrasy	 n.  癖好， 特性
practitioner	 n.  开业者
theophylline	 n.  茶碱
specify	 v.  详细说明
allegiance	 n.  忠诚， 拥护
biosphere	 n.  生物圈
urbanization	 n.  都市化
quarry	 v.  挖掘 n. 猎物；
yeast	 n.  酵母 in which it promotes alcoholic fermenta- tion, consists largely of cells of a fungus, and is used especially in the making of alcoholic liquors and as a leaven in baking)
gravel	 n.  碎石， 砂砾
leopard	 n.  豹， 美洲豹
hedgehog	 n.  【动】 猬； <美>豪猪
pertinent	 adj.  相关的
compose	 v.  组成； 使安定
spot	 n.  地点； 斑点； 现场
sterile	 adj.  不育的； 贫瘠的； 无效果的
specialization	 n.  特殊化
expulsion	 n.  驱逐； 开除
galactic	 adj.  银河的
partial	 adj.  部分的； 偏向的
supersonic	 adj. 超音速的； n.  超声波
biophysicist	 n.  生物物理学家
optimism	 n.  乐观， 乐观主义
caseload	 n.  办案量
retain	 v.  保留， 保持； 保存， 留住
exclusion	 n.  排除； 驱逐
drastic	 adj.  激烈的， 剧烈的
parole	 n.  假释
islet	 n.  小岛
educator	 n.  教育家
retail	 adj. 零售的； v.  零售
crude	 adj.  天然的； 粗糙的， 拙劣的
withstand	 v.  经受住； 抵挡， 反抗
inertia	 n.  惰性； 惯性
vacuum	 n.  真空
era	 n.  纪元， 年代； 时代
accommodate	 v.  供给住宿； 使适应
yield	 v.  产生； 屈从 n. 产量；
administer	 v.  管理， 执行； 用药)
cataclysm	 n.  大灾难； 大变动
cashew	 n.  腰果； 腰果树
transplant	 v.  移栽 in another soil or situation)； 移植(器官)(to transfer (an organ or tissue) from one part or individual to another)
assertion	 n.  宣布； 断言， 主张
ordinance	 n.  地方法令
deficit	 n.  赤字
outcome	 n.  结果
sacred	 adj.  神圣的
cathedral	 adj.  大教堂的 n. 大教堂；
synthesis	 n.  综合； 合成
polar	 adj.  地极的
millipede	 n.  千足虫
unobtrusive	 adj.  不显著的， 不引人注目的
cryptic	 adj.  神秘的； 含义模糊的
circumspect	 adj.  谨慎的
dispel	 v.  驱散； 消除
analogue	 n.  类似物
curriculum	 n.  全部课程
prototype	 n.  原型
repousse	 adj.  凸纹饰的； 金属细工的 n. 凸纹面；凸纹制作术；
demographic	 adj.  人口统计学的
reversal	 n.  逆转
species	 n.  物种
slip	 v.  滑行； 下降 n. 纸片；差错；
preceding	 adj.  在前的
dehydrate	 v.  脱水
shed	 v.  脱落； 流出， 散发
spinach	 n.  菠菜
fossilize	 v.  成为化石； 过时
fledgling	 adj.  新兴的 n. 雏鸟；
choreographer	 n.  舞蹈指导
semicircle	 n.  半圆； 半圆形体
rating	 n.  等级； 定额
municipality	 n.  市； 市政当局
screen	 v.  筛选； 检查 n. 屏幕；
condominium	 n.  共管； 公寓公私共有方式
degradation	 n.  退化； 降级； 堕落
correspond	 v.  相一致； 通信；  相应
spiced	 adj.  加香料的， 加调料的
perception	 n.  感觉； 洞察力
spur	 v. 促进，激励； n.  刺激
rear	 v. 抚养； adj.  后面的
undertake	 v.  采取； 接受
symmetry	 n.  对称； 均衡
indigenous	 adj.  土产的， 本地的
deprivation	 n.  剥夺； 缺乏
decimate	 v.  使急剧减少
presume	 v.  假定， 推测
bureau	 n.  局， 部， 处
snout	 n.  口鼻部
ale	 n.  淡色啤酒
buffer	 n.  缓冲物
complement	 v.  补充 n.  补足物； 【生】 补体
qualify	 v.  合格； 具有资格
intense	 adj.  强烈的， 剧烈的
acoustic	 adj.  听觉的， 有关声音的
estate	 n.  财产， 地产； 遗产
acreage	 n.  英亩数
applicable	 adj.  适用的， 适宜的
articulate	 v.  清楚地表达 adj.  善于表达的
brass	 n.  黄铜
adhere	 v.  粘附；  遵守， 坚持
sediment	 n.  【地】沉淀物
hybrid	 adj.  杂交的， 杂种的
rigorous	 adj.  严格的
contemporary	 adj. 当代的；同时代的； n.  同代人
secular	 adj.  世俗的， 尘世的
activate	 v.  使活动， 激活
strenuous	 adj.  费力的
amplifier	 n.  [电子]放大器， 扩大器； 扩音器
postal	 adj.  邮政的； 邮局的
credence	 n.  信任
gear	 v.  使…准备好 n. 齿轮；设备，工具；
precipitate	 v.  加速， 促成 adj.  鲁莽的
facilitate	 v.  容易， 促进
mandate	 v.  授权； 责令 n. 命令，指令；
propagandistic	 adj.  宣传的
progression	 n.  进展； 级数
respective	 adj.  分别的， 各自的
ensemble	 n.  合唱团
slot	 n.  狭缝； 空位
harden	 v.  变硬， 变坚固
ration	 n.  定量配给
domestication	 n.  驯养， 教化
dictate	 v.  规定， 支配
predict	 v.  预言， 预测
construction	 n.  建筑， 建筑物； 结构， 句法关系
dump	 v. 倾倒；倾销； n.  堆存处
commensurate	 adj.  相称的； 相当的
render	 v.  熔解； 提供； 使得
stratosphere	 n.  平流层， 同温层 above the surface and in which temperature increases gradually to about 32°F  and clouds rarely form)
haven	 n.  港口； 安息所， 避难所
frontier	 n.  国境； 边缘地带
undermine	 v.  破坏， 削弱
poultry	 n.  家禽
radical	 adj. 激进的； n.  激进分子
buffalo	 n.  水牛； 北美野牛
endeavor	 n.  努力； 事业
relieve	 v.  缓解； 减轻
contingent	 adj. 偶然发生的；有条件的； n.  分遣队
adjacent	 adj.  邻近的， 毗连的
prokaryote	 n.  原核生物
transport	 v.  运输， 运送
hoary	 adj.  古老的
specific	 adj.  具体的； 详细而精确的； 特殊的
intuitive	 adj.  直觉的
denunciatory	 adj.  谴责的
minute	 adj.  微小的， 极小的
generational	 adj.  一代的； 生育的
caller	 n.  访客； 打电话者； 召集员
demographer	 n.  人口统计学家
analogy	 n.  类推； 类比
engage	 v.  从事于， 忙于； 使订婚
chord	 n.  【几何】 弦
chore	 n.  家庭杂务； 令人厌烦的工作
appetite	 n.  食欲； 欲望
strategy	 n.  战略， 策略
remainder	 n.  【数】 余数； 剩余部分
hypothesis	 n.  假设， 假说
collapse	 v&n.  崩溃； 失败
territory	 n.  地区； 领土
comprehend	 v.  理解， 领会； 包含
spurious	 adj.  假的； 伪造的
droplet	 n.  小滴， 微滴
accurate	 adj.  正确的； 精确的
concession	 n.  让步
unprocessed	 adj.  未加工的
dichotomy	 n.  一分为二
predisposition	 n.  倾向； 易患病的体质
expertise	 n.  专门知识， 专长
battalion	 n.  军营， 军队
professional	 adj. 专业的；职业的； n.  专业人员
maximize	 v.  最大化
ingrained	 adj.  根深蒂固的
elective	 adj.  选修的 n. 选修课；
identification	 n.  鉴定， 识别； 认同
extraterrestrial	 adj.  地球外的
protein	 n.  蛋白质
implausible	 adj.  难以置信的
resort	 v. 求助； n.  度假胜地
testify	 v.  作证； 证明
underbelly	 n.  下腹部； 薄弱部分； 易受攻击的部位、 区域等
dwindle	 v.  变小
extracurricular	 adj.  课外的
dissociate	 v.  分离， 分开
reef	 n.  礁， 暗礁
encompass	 v.  包含； 围绕
margin	 n.  差额； 页边的空白； 边缘； 利润
megacity	 n.  大城市
pregnancy	 n.  怀孕
sustenance	 n.  食物， 养料
allergy	 n.  过敏症
refine	 v.  精炼； 改善
aspen	 adj.  类似白杨的 n. 白杨；
mount	 v.  增加， 增长
envelope	 n.  信封； 【天】 包层
acquiesce	 v.  勉强同意， 默许
waterfront	 n.  海滨； 滩
deposit	 v. 储蓄；放置； n.  存款； 押金； 沉积物
dissipate	 v.  消散， 消失
corruption	 n.  腐化， 堕落
mound	 n.  土丘， 土墩
fluctuation	 n.  波动
mosque	 n.  清真寺
insofar as	 在…的范围内；到…程度
simultaneous	 adj.  同时的， 同步的
guarantee	 v&n.  保证， 担保
predation	 n.  捕食； 掠夺行为
recommend	 v.  推荐； 建议
aristocracy	 n.  贵族政府， 贵族统治
predecessor	 n.  前任者； 人或事物
odor	 n.  气味
leach	 v.  过滤
acquire	 v.  取得， 获得
nebula	 n.  星云
morphine	 n.  吗啡
tactic	 n.  策略； 战术
automobile	 n.  汽车
in lieu of	 代，代替
default	 v.  违约； 拖欠
materialistic	 adj.  唯物主义的
helicopter	 n.  直升飞机
beverage	 n.  饮料
dividend	 n.  红利； 效益； 被除数
captive	 n.  俘虏
attribute	 v.  把…归于 n.  属性， 品质
mechanism	 n.  机械装置； 机制
indenture	 v.  以契约约束 n. 契约；
retard	 v.  妨碍； 减速
stitch	 n.  缝针； 针脚
genetic	 adj.  基因的， 遗传的
triumph	 n.  胜利， 成功； 欢欣
detection	 n.  察觉； 发现
esteem	 v&n.  尊重， 尊敬
telephoto	 adj.  用远距镜头照相的 n. 传真照片；摄远镜头；
ratification	 n.  正式批准
follicle	 n.  【解】 小囊
alga	 n.  水藻， 海藻
meteor	 n.  【天】 流星
optimum	 adj.  最好的， 最有利的
suppress	 v.  镇压； 抑制， 阻止
gravitational	 adj.  重力的， 万有引力的
broker	 n.  经纪人
bower	 n.  凉亭； 树荫
persuade	 v.  说服， 劝说
archaeological	 adj.  考古学的
consensus	 n.  意见一致
embellish	 v.  装饰； 润色
metric	 adj.  公制的
calf	 n.  牛犊， 幼崽
speculator	 n.  投机者； 思索者
dilemma	 n.  困境， 左右为难
rug	 n.   地毯； 毛毯
enact	 v.  制定或通过)
incorporate	 v.  合并， 并入
graphite	 n.  石墨
scrutinize	 v.  仔细观察， 审视
debate	 n&v.  辩论， 讨论
blackout	 n.  无线电通讯中断， 信号消失
extinguish	 v.  消灭； 熄灭
manumission	 n.  解放
vulnerable	 adj.  易受攻击的
affiliation	 n.  联系， 联合
counterpart	 n.  相应的人
segment	 n.  线段； 部分， 环节
inflationary	 adj.  通货膨胀的
donate	 v.  捐赠， 赠送
deplete	 v.  倒空， 耗尽
sovereign	 n.  君主； 元首
statistic	 n.  统计； 统计资料
coronary	 adj.  冠状动脉的
cater	 v.  满足
overlay	 v.  覆盖
odometer	 n.  里程表
taboo	 adj. 讳忌的； n.  禁忌； 禁止
superb	 adj.  上乘的， 极好的
mole	 n.  鼹鼠
mold	 v.  塑造； 对…产生影响 n. 模子；
significant	 adj.  相当数量的； 意义重大的
bold	 adj.  勇敢的， 大胆的
duplicate	 adj. 复制的； v.  复制； 重复 n.  复制品
catalogue	 v.  为…编目录 n. 商品目录；
unbridled	 adj.  放纵的， 无约束的
volunteer	 adj.  自愿的 n. 志愿者；
overlap	 v.  重叠
debase	 v.  降低；  降低的成色
eradicate	 v.  根除， 消灭
senate	 n.  [S~] 参议院， 上议院
patriotism	 n.  爱国主义， 爱国心
bolt	 n.  螺栓； 雷电
migrate	 v.  移居
gymnast	 n.  体操运动员
truce	 n.  休战， 停战
congressional	 adj.  国会的， 议会的
pagination	 n.  编页码， 标注页码
string	 v. 用线串； n.  弦； 一串
submit	 v.  提交； 屈从
affluent	 adj.  富裕的
boom	 v. 迅速发展；兴旺； n.  繁荣
whisker	 n.  腮须； 胡须
abolish	 v.  取消， 废除
description	 n.  描写， 描述
critique	 v.  批判性地讨论 n. 评论；
originator	 n.  发起人
summit	 n.  峰顶； 最高级会议
renounce	 v.  声明放弃； 拒绝承认
recession	 n.  衰退， 萧条
shortfall	 n.  亏空； 不足
negative	 adj.  否定的； 消极的； 负的
protégé	 n.  被保护人； 门徒
impose	 v.  征； 处以；  强制实行； 强加于
ally	 v.  结盟 n.  同盟者， 同盟国
mantle	 n.  覆盖物； 地幔
factor	 n.  因素； 【数】 因子
paleolithic	 adj.  旧石器时代的
tri-state	 adj.  三州的
princely	 adj.  高贵的； 威严的
substance	 n.  实质； 物质
boreal	 adj.  北方的
approbation	 n.  赞成， 同意
sculpture	 v.  雕刻 n. 雕塑品；雕塑；
saturated	 adj.  饱和的； 浸透的
tribal	 adj.  部落的， 宗族的
infringer	 n.  侵犯人
bond	 v.   结合 n. 结合；债券；
contamination	 n.  污染， 玷污； 污染物
demonstrably	 adv.  可证实地， 显然地
arable	 adj.  可耕的
antitrust	 adj.  反托拉斯的， 反垄断的
sensation	 n.  感觉； 引起轰动的人或事
sibling	 n.  兄弟或姊妹
oust	 v.  驱逐， 剥夺； 取代
grind	 v.  磨； 伴随摩擦而移动
desegregation	 n.  取消种族隔离
calligraphic	 adj.  书法的， 书写的
aquatic	 adj.  水的， 与水有关的
flippant	 adj.  无礼的； 轻率的
counterattack	 n.  反攻， 反击
discard	 v.  扔掉， 丢弃
delicate	 adj.  微妙的； 精致的；  脆弱的
excluder	 n.  排除器
bounce	 v. 弹起，反弹； n.  弹起
subsidy	 n.  津贴， 补助
criteria	 n.  标准
underwrite	 v.  承诺支付； 给…保险
imitative	 adj.  模仿的； 仿制的
crustal	 adj.  壳的； 地壳的
tissue	 n.  纸巾； 【生】 组织
loosen	 v.  变松， 松开
refiner	 n.  精炼机 ； 精制者， 精炼者
carpenter	 n.  木匠
steppe	 n.  无树木的大草原
billing	 n.  营业额； 广告
modest	 adj.  适度的； 朴实的； 谦逊的
temblor	 n.  <美>地震
crush	 v.  挤压； 压碎 n. 粉碎；压榨；迷恋；
slice	 n.  薄片， 切片； 部分
dietary	 adj.  饮食的
larva	 n. 〔昆虫的〕幼虫，幼体
electron	 n.  电子 of an atom and that by its movement causes an electric current in metal)
burrow	 v.  挖洞 n. 洞穴；
incline	 v.  使倾斜 n.  斜坡
olfactory	 adj.  嗅觉的
embed	 v.  嵌入
elevate	 v.  抬起； 使升高
megalithic	 adj.  巨石制的
designate	 v.  指派； 指明， 指定
promising	 adj.  有希望的， 有前途的
nonessential	 adj.  不重要的； 非必需的
slick	 adj.  光滑的； 聪明的
ambivalent	 adj.  有矛盾看法的
boardinghouse	 n.  寄宿公寓
liver	 n.  肝脏
probability	 n.  概率； 可能性
physiology	 n.  生理学； 生理机能
epic	 n.  史诗； 叙事诗
trunk	 n.  树干； 躯干； 主干
unification	 n.  统一； 联合
effigy	 n.  雕像， 肖像
explicit	 adj.  清楚的； 明确的
upholstered	 adj.  装软垫的
miraculous	 adj.  不可思议的， 奇迹的
omen	 n.  征兆， 预兆
utilize	 v.  利用， 使用
prevail	 v.  战胜； 盛行
radiocarbon	 n.  放射性碳
excessive	 adj.  过分的， 极度的， 过多的
grill	 n.  烤架
participation	 n.  参加； 参与
implicit	 adj.  含蓄的； 潜在的
intensify	 v.  加强， 增强
futile	 adj.  无益的； 无用的
harsh	 adj.  严酷的； 严厉的； 粗糙的； 刺耳的
increment	 n.  增量； 增加
unilateral	 adj.  单侧的； 单方面的
isotope	 n.  同位素
vertice	 n.  顶点
uninitiated	 adj.  外行的， 缺乏丰富知识的
cramped	 adj.  狭窄的； 狭促的
preferential	 adj.  优先的
scrape	 v&n.  刮擦； 擦伤
meteorological	 adj.  气象学的； 气象的
bilateral	 adj.  双边的
plateau	 v.  达到平台期 n. 平台期；
eschew	 v.  避开
amass	 v.  积聚
hardcover	 adj.  精装的 n. 精装版本；
scorpion	 n.  蝎子
attrition	 n.  磨损； 人员耗损
reliance	 n.  信赖， 信任
explore	 v.  探索， 探究
electricity	 n.  电力； 电学； 强烈的紧张情绪
tentative	 adj.  试验的， 试探的； 犹豫的
staggering	 adj.  令人惊愕的
inaccurate	 adj.  错误的； 不准确的
crust	 n.  外壳； 地壳
leery	 adj.  怀疑的， 不相信的
aggravate	 v.  加重， 恶化
wanton	 adj.  无节制的， 放纵的； 顽皮的
addictive	 adj.  上瘾的
circumference	 n.  圆周； 圆周长
organization	 n.  组织； 机构， 团体
eruption	 n.  爆发， 喷发
preside	 v.   担任主席， 主持
cyclic	 adj.  循环的
colossal	 adj.  巨大的， 庞大的
mooring	 n.  停泊处
indicator	 n.  暗示； 指示器
offspring	 n.  崽； 后代
pharmaceutical	 adj.  制药的
whim	 n.  多变； 怪念头
membrane	 n.  薄膜， 细胞膜
heist	 v.  抢劫， 强夺 n. 抢劫；
arrest	 v.  依法逮捕， 拘留； 阻止， 抑制
navy	 n.  海军
mature	 v&a.  成熟
disability	 n.  无能； 无资格
insecticide	 n.  杀虫剂
philanthropic	 adj.  慈善的， 乐善好施的
alleviate	 v.  减轻， 缓和
precedence	 n.  优先， 居先
rumor	 n.  传闻， 谣言
protocol	 n.  条约草案， 协议
overflow	 v.  溢出
provoke	 v.  产生， 引起
threaten	 v.  威胁
condescending	 adj.  俯就的， 屈尊的； 有优越感的
enrich	 v.  富裕； 丰富
rhetoric	 n.  雄辩， 辩才
inverted	 adj.  反向的， 倒转的
vine	 n.  葡萄树； 蔓生植物 that lack specialized adaptations for climbing)
strain	 v.  拉紧 n. 血统；张力，拉紧；【生】品种；
speculation	 n.  思索； 推测； 投机
negotiate	 v.  谈判； 达成协议
intrigue	 v.  引起兴趣 n. 阴谋；
marketplace	 n.  市场； 市集
moth	 n.  蛾； 蛀虫
handicap	 v.   不利 n. 障碍；残废；
shatter	 v.  粉碎， 砸碎； 破坏
domesticity	 n.  家庭生活； 专心于家务
strait	 n.  海峡
nutrition	 n.  营养
absenteeism	 n.  旷工， 旷课
obsolescence	 n.  荒废； 过时
transfer	 v.  转移 n.  调动； 转让
veteran	 n.  老兵
cereal	 n.  谷类； 谷类食品
noncommercial	 adj.  非商业的
lactation	 n.  哺乳， 哺乳期
effect	 v. 生效；引起； n.  效应； 结果
unfavorable	 adj.  不宜的； 令人不快的； 不顺利的
diversion	 n.  转移； 消遣
unscrupulous	 adj.  无道德原则的， 不讲道德的
diaper	 n.  尿布
perceive	 v.  察觉， 发觉
embarrass	 v.  尴尬
raid	 n&v.  劫掠； 突袭
overlie	 v.  躺在…上面
sponsor	 v. 赞助； n.  赞助人
acute	 adj.  灵敏的； 严重的
pacemaker	 n.  领跑者
commoner	 n.  平民
crucial	 adj.  决定性的； 至关紧要的
contribute	 v.  贡献； 投稿； 捐献
faith	 n.  信任； 信仰
insert	 v.  插入
downplay	 v.  贬低， 不予重视
sublanguage	 n.  [计]子语言
inspiration	 n.  启示， 灵感
malaria	 n.  疟疾； 瘴气
integrated	 adj.  综合的； 完整的
highlight	 v.  突出； 集中注意力于
strive	 v.  努力， 奋斗
tortoise	 n.  乌龟， 龟
candidate	 n.  候选人； 投考者
fungus	 n.  真菌， 霉菌； 菌类
wig	 v.  激动， 发狂 n. 假发；
parallel	 adj. 平行的；类似的； n.  类似， 相似处
reject	 v.  拒绝， 抵制
sheer	 adj.  薄的； 纯粹的
sequester	 v.  隐退； 使隔离
rinse	 v.  冲洗
depiction	 n.  描写； 叙述
enzyme	 n.  酵素， 酶 without being changed itself)
comply	 v.  遵循
respire	 v.  呼吸
deviate	 v.  越轨， 脱离
adherence	 n.  坚持； 依附； 忠诚
regiment	 n.  军团
prosecutor	 n.  检察官； 起诉人， 原告
feudal	 adj.  封建制度的
diminish	 v.  减少， 削弱
surpass	 v.  超越； 胜过
posterity	 n.  子孙， 后代
depression	 n.  消沉； 萧条
disproportionate	 adj.  不成比例的
equivalent	 adj. 相同的，相当的； n.  等价物
militancy	 n.  战斗； 战斗精神
overextend	 v.  过度扩展； 使冒过大风险
sensational	 adj.  轰动的； 非常好的
plough	 v.  费力穿过 n. 犁；
plague	 v.  使苦恼， 烦扰 n. 瘟疫；
equity	 n.  公平， 公正
intermediary	 n.  中间人， 媒介物
aversion	 n.  厌恶， 反感
bar	 v. 禁止，阻止； n.  棒； 酒吧
diplomatic	 adj.  外交的
husk	 v.  削皮 n. 外皮；
untainted	 adj.  无污点的
disenchanted	 adj.  不再着迷的， 不抱有幻想的
complex	 adj.  复杂的
draft	 n.  草稿， 草案； 汇票
manufacturing	 adj.  制造业的(of or related to machinery) n. 制造，制造业fromrawmaterials)；
pension	 n.  养老金， 退休金
assumption	 n.  假定， 设想； 担任
humidity	 n.  湿度， 湿气
fluid	 adj.  流体的， 流动的 n. 流体；
outlet	 n.  出口， 通风口； 批发商店
pamphlet	 n.  小册子
addition	 n.  添加， 增加物； 加法
overcharge	 v.  过度充电； 索价过高， 收费过高
cosmic	 adj.  宇宙的
posit	 v.  断定， 认为
vein	 n.  纹理； 矿脉； 静脉
shrink	 v.  收缩； 减小
documentation	 n.  证明文件； 史实
ancestor	 n.  祖先
proliferate	 v.  激增； 繁殖
hierarchy	 n.  等级制度， 层次
hazardous	 adj.  危险的， 冒险的
artery	 n.  【医】 动脉
amphitheater	 n.  竞技场
embalm	 v.  保存； 铭记； 以香油 涂尸防腐
extend	 v.  延展， 延长
solvency	 n.  溶解力； 偿付能力
canyon	 n.  峡谷
upstate	 adj.  在州北部的
interpretation	 n.  解释， 说明； 翻译
intermediate	 adj.  中间的， 居中的
presuppose	 v.  以…为先决条件
competitive	 adj.  有竞争性的； 比赛的
consideration	 n.  考虑； 报酬
payroll	 n.  薪金名单； 工资总额
sentient	 adj.  有感觉的， 有知觉的
expound	 v.  解释； 阐述
inscribe	 v.  刻； 【数】 使内接
scheme	 n.  方案
exacerbate	 v.  加重， 恶化
insulate	 v.  使绝缘
takeover	 n.  接管； 收购
scarcity	 n.  不足， 缺乏
appendicitis	 n.  阑尾炎， 盲肠炎
customize	 v.  定制， 定做
anterior	 adj.  先前的； 前面的
civic	 adj.  城市的； 公民的； 平民的
anesthesia	 n.  麻醉
viability	 n.  可行性； 生存能力
refinery	 n.  精炼厂
recourse	 n.   求助； 依靠
isolate	 v. 使孤立；隔离； adj.  孤立的
multinational	 adj. 跨国公司的；多国的； n.  跨国公司
extinction	 n.  消灭， 废除
metaphor	 n.  隐喻， 暗喻
subsequent	 adj.  随后的， 接续的
relinquish	 v.  放弃； 交出
indicate	 v.  显示， 表明； 指出
panel	 n.  专门小组
sidestep	 v.  横跨一步躲避； 回避
omission	 n.  遗漏
immobilize	 v.  使固定， 使不动； 使停止流通  from circulation)
metabolic	 adj.  新陈代谢的
innovation	 n.  创新， 革新
plummet	 v.  骤然下跌
litter	 v.  乱丢 n. 垃圾；
oval	 adj.  卵形的， 椭圆形的
alternate	 adj.  交替的， 更迭的 happening or following one after the other regularly) v.  交替， 轮流
indigent	 adj.  贫穷的
procedure	 n.  程序； 步骤
biography	 n.  传记
sample	 v.  取样 n. 样品；标本；
integrate	 v.  一体化， 成整体
renal	 adj.  肾脏的， 肾的
tropical	 adj.  热带的
plunge	 v.  骤降； 跳进
skeptical	 adj.  怀疑的
planetary	 adj.  行星的
petition	 n.  请愿； 请愿书
diagnose	 v.  诊断
vicinity	 n.  附近， 接近
decipher	 v.  破译
validity	 n.  有效性； 合法性； 正确性
sewage	 n.  污物， 污水
encode	 v.  译码， 编码
expenditure	 n.  消耗； 花费； 支出
clarify	 v.  澄清
unpromising	 adj.  无前途的， 没有希望的
furnace	 n.  熔炉)
circulatory	 adj.  循环的
haunt	 v. 常去，常到；； 萦绕于
precede	 v.  在…之前， 早于
stamina	 n.  耐力； 持久力
chaise	 n.  两轮轻便马车
congenial	 adj.  舒适的
residual	 adj.  残余的， 剩余的
compensatorily	 adv.  补偿性地
stroll	 v&n.  闲逛， 散步
differentiate	 v.  区别； 【生】分化
reticent	 adj.  缄默的
parish	 n.  教区； 教区全体居民
ideographic	 adj.  表意文字的
excavation	 n.  挖掘
hierarchical	 adj.  分层的； 等级的
garment	 n.  衣服， 外衣
advocacy	 n.  拥护， 支持
discharge	 v&n.  排放； 释放； 解雇
exclude	 v.  排斥， 排除
demobilization	 n.  遣散； 复员
criticism	 n.  批评； 评论
geologist	 n.  地质学家
creativity	 n.  创造力， 创作力
prorate	 v.  <美>按比例分配
needy	 adj.  贫穷的
prospective	 adj.  未来的； 预期的 n. 预期，展望；
perturb	 v.  打扰； 【天】 摄动
oxidize	 v.  氧化， 生锈
digit	 n.  数字； 【数】 十位数
specious	 adj.  华而不实的； 似是而非的
deduct	 v.  扣除； 演绎
voracious	 adj.  狼吞虎咽的； 贪婪的
coinage	 n.  货币， 货币制度
pallid	 adj.  苍白的， 没血色的； 无生气的
unpredictable	 adj.  不可预知的
portray	 v.  描写， 描绘
scrub	 v. 擦洗； n.  矮树
profound	 adj.  深刻的， 意义深远的
squeak	 n.  吱吱叫
electromagnetic	 adj.  电磁的
adjust	 v.  调节， 改变…以适应
aspiration	 n.  志向， 抱负
excrete	 v.  分泌， 排泄 to pass out  from the system)
vigorous	 adj.  精力旺盛的， 健壮的
hieroglyphic	 n.  象形文字
unaccompanied	 adj.  无伴奏的； 无伴随的
frame	 v.  诬陷 so that a verdict of guilty is assured) n. 框架；
humane	 adj.  仁慈的
perpendicular	 adj. 垂直的； n.  垂线
compelling	 adj.  引起兴趣的
parity	 n.  同等， 相等
vocal	 adj.  声音的； 歌唱的
songbird	 n.  鸣禽， 鸣鸟； 女歌手
deem	 v.  认为； 相信
industrialize	 v.  工业化
compel	 v.  强迫
depress	 v.  使沮丧；  削弱； 使萧条
precaution	 n.  预防， 警惕
burden	 v.  加重压于 n. 负担；
plow	 v.  费力穿过 n. 犁；
hover	 v.  盘旋； 徘徊
personality	 n.  个性， 品格； 名人
terminology	 n.  术语
sanction	 n&v.  批准； 制裁
plot	 n.  小块土地； 计划； 情节
deduce	 v.  推断， 演绎
client	 n.  委托人； 顾客
acoustical	 adj.  声学的， 听觉的
prosperity	 n.  成功； 繁荣
plankton	 n.  浮游生物
mosaics	 n.  马赛克； 嵌合体
sip	 v.  啜饮， 呷
lump	 v.  将…归并到一起 n. 块，肿块；
contend	 v.  与困难做斗争， 应付； 主张
conversion	 n.  转换； 折合； 财产转移
practical	 adj.  实际的； 实用性的
attendee	 n.  出席者， 在场者
pesticide	 n.  杀虫剂
bound	 v. 包围，限制； adj. 必定的； 密切关联的
conserve	 v.  保存； 节约
stroke	 n.  中风； 击， 敲； 一下完成的动作
wreath	 n.  花冠， 花环
fivefold	 a&ad.  五倍的
pyramid	 n.  角锥； 金字塔
unwieldy	 adj.  麻烦的， 难处理的
realm	 n.  领域； 国度
cylinder	 n.  圆柱体
avoid	 v.  避开， 躲避
bid	 n.  出价， 投标； 投标的价格
prompt	 v. 促使，推动；提示； adj.  敏捷的
merger	 n.  合并； 并购
withdraw	 v.  收回； 退出
assign	 v.  指派； 分配； 归于
elaborate	 adj.  精心制作的 v.  详述， 详细制定
drab	 adj.  土褐色的
decade	 n.  十年， 十年期
select	 v.  挑选， 选择
congress	 n.  议会， 国会； 代表大会
mechanical	 adj.  机械的； 呆板的
recommendation	 n.  推荐； 推荐信
magmatic	 adj.  岩浆的
invoke	 v.  行使， 实行
welfare	 n.  繁荣； 福利
flourish	 v.  繁荣；活跃
intricate	 adj.  复杂的
punishable	 adj.  可罚的； 该罚的
contemplate	 v.  沉思； 打算， 预期
vessel	 n.  船； 容器； 导管
rodent	 n.  啮齿类动物
modem	 n.  调制解调器
sentence	 v.  判决， 宣判 n. 句子；宣判，判决；
maturity	 n.  成熟
literally	 adv.  照字面意思地
subsistence	 n.  生存， 生计
shareholder	 n.  股票持有人； 股东
index	 n.  索引； 指数
marshy	 adj.  沼泽的， 生于沼泽的
salable	 adj.  可出售的， 卖得出的
foresight	 n.  远见， 深谋远虑
filament	 n.  灯丝； 纤维
odd	 adj. 奇怪的；奇数的；
announce	 v.  宣布， 发表； 通报…的到来
additive	 adj. 附加的； n.  添加剂
congested	 adj.  拥挤不堪的， 充塞的
fodder	 n.  草料
chalice	 n.  杯； 圣餐杯
malleable	 adj.  易改变的； 可塑的
supplement	 v.  补充， 增补 n.  补充， 增补
intercept	 v.  拦截， 截取
contrast	 v.  对比； 使与对照 n.  对比； 差别
bluegrass	 n.  蓝草音乐； 莓系属的牧草， 早熟禾属植物
exclusively	 adv.  专有地， 排他地
doctrine	 n.  教义； 学说
ferrous	 adj.  含铁的
bacterium	 n. [微] 细菌；杆菌属
proportion	 n.  比例
mediate	 v. 调解；作为媒介引起； adj.  居中的
accrue	 v.  自然增长， 自然产生
prophet	 n.  先知， 预言家
camcorder	 n.  摄录像机
subscription	 n.  捐献； 订阅； 签署
occurrence	 n.  发生； 事件
bankruptcy	 n.  破产， 倒闭
amplify	 v.  增强； 详述
inflation	 n.  膨胀； 通货膨胀
ethanol	 n.  乙醇， 酒精
lure	 v.  吸引， 诱惑
aura	 n.  气味， 香味
whirl	 v.  旋转， 急转
sphere	 n.  球； 领域
inflammation	 n.  发炎； 炎症
y-axis	 n.  坐标轴中的Y轴
dire	 adj.  可怕的； 悲惨的
slump	 v&n.  下降， 暴跌
prejudice	 v&n.  偏见， 歧视
digest	 v.  消化 into absorbable form)； 吸收(to absorb; to take into the mind or memory) n.  摘要
clergy	 n.  牧师； 神职人员
dependence	 n.  依赖， 依靠
unanticipated	 adj.  意料之外的， 未预料到的
proficient	 adj.  熟练的， 精通的
affordable	 adj.  负担得起的， 便宜的
immigration	 n.  外来移民； 移居
proliferation	 n.  增殖； 扩散
predominate	 v.  统治， 主导； 占优势
preindustrial	 adj.  工业化前的； 未工业化的
conglomerate	 n.  企业集团
photon	 n.  光子， 光量子
counterevidence	 n.  反证
hide	 v. 隐藏；隐瞒； n.  兽皮
scrawny	 adj.  骨瘦如柴的
corporate	 adj.  团体的； 法人的， 公司的
stabilize	 v.  使稳定， 使坚固
compensate	 v.  补偿； 偿还； 付报酬
transaction	 n.  交易； 事务
constant	 adj. 稳定的，不变的； n.  常数， 恒量
smog	 n.  烟雾
certify	 v.  保证； 证明
outrage	 v. 激怒； n.  愤怒
coloration	 n.  着色法， 染色法； 颜色， 色泽
solitary	 adj.  单独的； 【动】 独居的
constructivist	 n.  构成主义者
scramble	 v.  攀登； 争夺
communal	 adj.  全体共用的， 共享的
nutritious	 adj.  有营养成分的， 营养的
maturation	 n.  成熟
edge	 n.  优势； 边
split	 v.  分裂， 裂开
proceeds	 n.  收益
maternity	 adj.  产妇的 n. 母性；妇产科医院；
sufficient	 adj.  足够的
imposition	 n.  征收； 强加
relentless	 adj.  无情的； 不断的
claim	 v.  声称； 认领； 索取 n. 声称；
antique	 adj. 古时的，古老的； n.  古董
petroleum	 n.  石油
chronic	 adj.  长期的， 慢性的
overstock	 v&n.  库存过剩
novice	 n.  新手
toxic	 adj.  有毒的
discretion	 n.  谨慎； 审慎
preserve	 v. 保持，维持； n.  野生动物保护区
rekindle	 v.  重新激起
deter	 v.  威慑； 阻止
entry	 n.  进入； 入口； 登记
synthetic	 adj.  合成的 n. 合成物；
headquarters	 n.  总部， 指挥部
deduction	 n.  扣除， 减除； 推论
fiscal	 adj.  国库的， 财政的
proclaim	 v.  宣告， 声明； 显示
conservatism	 n.  保守主义； 守旧性
perimeter	 n.  周长
prediction	 n.  预言； 预报
retrieve	 v.  取回； 恢复； 检索
survey	 v.  调查； 视察 n.  调查
malice	 n.  恶意， 怨恨
jeopardize	 v.  危及， 危害
codify	 v.  整理； 系统化
code	 n.  法规； 准则
decorous	 adj.  符合礼节的
displace	 v.  免职； 转移； 取代
predominant	 adj.  有势力的； 主要的
domesticate	 v.  驯养， 教化
ideology	 n.  思想体系， 意识形态
counterproductive	 adj.  事与愿违的
recipe	 n.  食谱
roost	 v.  栖息
apportion	 v.  分配
investigate	 v.  调查
hostility	 n.  敌对， 不友好； 憎恨
autobiography	 n.  自传
veritable	 adj.  确实的， 真正的
pseudonym	 n.  假名； 笔名
hemoglobin	 n.  【生化】 血红蛋白， 血色素
preservation	 n.  保存， 保留
considerable	 adj.  相当多的； 值得考虑的
toxin	 n.  毒素， 毒质
audiophile	 n.  唱片爱好者； 爱玩高级音响的人
reserve	 v.  保留； 储备 n. 储备；
invertebrate	 n.  无脊椎动物
viable	 adj.  可行的； 能活下去的
cripple	 v.  使…成残废 n. 瘸子；
facial	 adj.  面孔的； 面部的
recover	 v.  恢复
influx	 n.  流入， 汇集
miscarriage	 n.  流产； 失败； 误送
clockwise	 a&ad.  顺时针方向的
carcinogen	 n.  致癌物
devastate	 v.  毁坏
embark	 v.  着手， 开始做
metamorphic	 adj.  变质的； 变性的
prodigy	 n.  奇迹； 奇才； 奇观
proviso	 n.  限制性条款
exonerate	 v.  证明…无罪；  免受指控
control	 v. 控制，管理； n.   对照， 参照物
medication	 n.  药物疗法； 药物， 药剂
purview	 n.  范围
friction	 n.  摩擦
confer	 v.  讨论； 授予
laxity	 n.  疏忽， 不严格
lobby	 v.  向 进行游说 n. 大厅，休息室；
acknowledge	 v.  承认； 致谢
dormant	 adj.  【生】休眠的
receptor	 n.  感受器； 受体
equip	 v.  装备， 配备
manuscript	 n.  原稿， 手稿
deferential	 adj.  恭顺的
constructivism	 n.  结构主义， 构成派
hereditary	 adj.  世袭的； 遗传的
inflict	 v.  使…遭受
diagonal	 n.  对角线
inland	 adv.  在内地 adj.  内陆的 n. 内陆；
stance	 n.  态度， 立场
infringement	 n.  侵犯； 违反
stumble	 v&n.  绊倒
iridescence	 n.  彩虹色
strategic	 adj.  战略上的； 关键的， 重要的
readily	 adv.  乐意地； 容易地
coherent	 adj.  连贯的； 清楚的； 附着的， 黏在一起的
clandestine	 adj.  秘密的， 暗中从事的
delta	 n.  三角洲
dwelling	 n.  住处， 寓所
adaptation	 n.  适应； 改编
convenience	 n.   便利
determination	 n.  决心； 果断
infrared	 adj.  红外线的， 红外区的
episode	 n.  一段情节；  事件
discipline	 v. 训练，调教； n.  纪律； 学科
calculus	 n.  结石； 微积分学
expedient	 n.  权宜之计； 对策
animate	 v.  使有生气； 绘制 n. 有生命的；
objective	 adj. 客观的； n.  目标， 目的
victimize	 v.  使受害， 迫害； 使牺牲
emission	 n.  散发
exert	 v.  发挥、 运用 into action or to tiring effort)； 施加(to employ, to wield)
hinder	 v.  阻止； 妨碍
scent	 n.  气味； 香味
estimate	 v&n.  估计， 评价
lysis	 n.  分解
diploma	 n.  文凭
pinpoint	 v.  精确定位； 准确解释或确定 n. 针尖；极小之物；
inadequate	 adj.  不充分的
inevitable	 adj.  不可避免的
unrealistic	 adj.  不切实际的， 不实在的
trench	 n.  沟渠； 海沟
recreation	 n.  娱乐活动， 消遣
subtract	 v.  减， 减去
asthma	 n.  哮喘
allowance	 n.  允许； 津贴， 补助费
hurricane	 n.  飓风
hike	 n.  徒步旅行
squirrel	 v.  贮藏 n. 松鼠；
vaccinate	 v.  接种疫苗
cognitive	 adj.  认知的
generalization	 n.  概括； 普遍化
attorney	 n.  律师
expire	 v.  期满， 终止； 断气； 呼气
chauvinism	 n.  沙文主义， 盲目爱国主义
mystic	 adj. 神秘的；神秘主义的； n.  神秘主义者
minus	 adj.  减的； 负的 prep. 减去；
dosage	 n.  剂量
sue	 v.  向…起诉， 提起诉讼
conservative	 adj. 保守的； n.  保守派
access	 v.  进入 n. 通路；接近的权利；途径；
primitive	 adj.  原始的； 简单的
unsubstantiated	 adj.  未经证实的， 无事实根据的
cooperate	 v.  合作； 配合
cabin	 n.  舱
delve	 v.  钻研， 深入探索
epochal	 adj.  划时代的； 有重大意义的
fjord	 n.  峡湾
democrat	 n.  民主主义者； [D～]美国民主党人
apprenticeship	 n.  学徒期； 学徒身份
audit	 n.  审计
disturb	 v.  打乱， 扰乱
copper	 adj.  铜的 n. 铜；
insuperable	 adj.  难以克服的
persist	 v.  坚持； 继续
intake	 n.  摄取， 摄入
heretical	 adj.  异端的， 异教的
calendar	 n.  日历； 历法； 日程表
oversupply	 v. 过多供给； n.  供给过多
orator	 n.  演说者； 演讲者； 雄辩家
speculate	 v.  推测； 做投机买卖
launch	 v.  发起； 推出； 发射
sanitary	 adj.  卫生的； 公共卫生的
heed	 v.  注意， 留心
dismantle	 v.  拆除； 废除， 取消
boomerang	 n.  回飞棒； 自食其果的言行
gyroscope	 n.  陀螺， 回转仪
unequalled	 adj.  无与伦比的； 不等同的
confirm	 v.  证实， 使有效； 确定
homeostasis	 n.  体内平衡
mortality	 n.  死亡率
appoint	 v.  任命， 指派
assist	 v.  参加， 出席； 帮助， 促进 n. 帮助；
pulp	 n.  浆状物； 纸浆
crossbred	 adj.  杂种的
antibiotic	 n.  抗生素
dissent	 v&n.  不同意
ignite	 v.  点燃； 着火
commercial	 adj. 商业的； n.  商业广告
separate	 adj.  分开的； 单个的； 不同的 v.  分开； 分类
saline	 adj.  含盐的， 咸的
urine	 n.  尿
calamitous	 adj.  灾难的， 悲惨的
trout	 n.  鲑鱼
advocate	 v.  提倡， 支持 n.  支持者， 提倡者
confine	 v. 限制，禁闭；
quest	 v&n.  寻找； 寻求
frequency	 n.  频率
elicit	 v.  引出， 引起
ambiguity	 n.  模棱两可， 模糊
trivial	 adj.  琐屑的， 微不足道的
sniper	 n.  狙击手
enthusiastically	 adv.  热情地， 热烈地
missile	 n.  导弹
longevity	 n.  长寿
dynamic	 n. 动力；
reluctant	 adj.  不情愿的， 勉强的
generate	 v.  生成， 产生； 引起
extreme	 adj.  极度的， 极端的 n. 极端；
substrate	 n.  底土层， 底土
anecdotal	 adj.  轶事的
preservative	 adj. 防腐的； n.  防腐剂
egalitarianism	 n.  平等主义
coordinate	 v.  协调 n.  坐标
authoritative	 adj.  权威的， 官方的； 专断的
purchaser	 n.  买方， 购买者
epidemic	 adj. 传染的；流行性的； n. 流行病
horticultural	 adj.  园艺的； 园艺学的
retarded	 adj.  智力迟钝的； 发展迟缓的
dismal	 adj.  凄凉的； 暗淡的
drizzle	 n.  细雨； 细流
astronomy	 n.  天文学
bluntly	 adv.  坦率地， 率直地
recluse	 adj.  隐居的 n. 隐士；
numerator	 n.  【数】分子
ranch	 n.  大农场
enhanced	 adj.  加强的； 增大的
flavor	 n.  风味； 香料
horseshoe	 n.  马蹄铁； U形物
enfranchisement	 n.  解放， 释放
discord	 n.  不和， 纷争
extract	 v.  提取， 榨取
obscure	 adj. 模糊的； v.  使…不明显
ripple	 v. 起波纹；传开； n.  波纹
dismay	 v&n.  沮丧
altruism	 n.  利他主义， 无私
forge	 v. 锻造；达成，使形成； n.  铁匠铺
hint	 n. 线索；
carpet	 v.  铺地毯 n. 地毯；
noxious	 adj.  有毒的， 有害的
bolster	 v.  支持； 鼓励
demonstrate	 v.  证明； 显示； 示威游行
conspire	 v.  阴谋， 共谋
storefront	 n.  店堂， 沿街铺面
ingenious	 adj.  聪明的； 创新的
questionnaire	 n.  问卷， 调查表
mortar	 v.  用灰泥涂抹 n. 灰泥；
throne	 n.  王位； 王权
reciprocal	 adj. 相互的；相应的； n.  【数】 倒数； 互相起作用的事物
vertical	 adj.  垂直的
inventory	 n.  存货
perpetuate	 v.  延长…的存在， 使永记不忘
austere	 adj.  严格的， 节制的
quail	 n.  鹌鹑
fraternal	 adj.  兄弟的
kin	 n.  <集合词>家属， 亲戚
proprietary	 adj.  所有的， 私人拥有的
similarity	 n.  相似点
paleoclimatologist	 n.  古气候学家
virtue	 n.  美德； 优点； 力量
emphasize	 v.  着重， 强调
bona fide	 adj.  可信的； 真诚的， 真实的
prestigious	 adj.  有名望的， 有威信的
perishable	 adj. 易腐败的； n.  易腐败的东西
brutal	 adj.  残忍的
slight	 adj.  少量的； 微不足道的
ore	 n.  矿， 矿砂， 矿石
previous	 adj.  前面的， 在前的
regime	 n.  形态； 政权
transmit	 v.  传送)； 传播(to spread)
consumption	 n.  消耗， 消费
repertory	 n.  剧目， 作品
anthropologist	 n.  人类学家
cumbersome	 adj.  累赘的； 麻烦的
superior	 adj. 较好的； n.  上级， 长官
vaccine	 n.  牛痘苗， 疫苗
premature	 adj.  早产的； 早熟的
restitution	 n.  归还； 赔偿
drought	 n.  干旱， 旱灾
noncommittal	 adj.  不负责的； 不明朗的
periodical	 adj. 周期的，定期的；期刊的； n.  期刊
subsidize	 v.  补助， 资助
compensation	 n.  补偿； 赔偿金； 报酬
compromise	 v. 妥协； n.  折衷
outpost	 n.  前哨
ecosystem	 n.  生态系统
woven	 n.  织物
seminar	 n.  研讨会
potent	 adj.  效力强的， 烈性的
therapeutic	 adj.  治病的
folklore	 n.  民俗文化； 民俗学
venom	 n.  毒液； 痛恨
hazard	 v.  尝试着做 n. 危险，冒险；
justify	 v.  证明…正当或有理
vegetative	 adj.  植物的， 有关植物生长的
transatlantic	 adj.  横渡大西洋的
timber	 n.  木材， 木料
enshrine	 v.  奉为神圣
seminal	 adj.  开创性的； 重要的； 种子的； 精液的
simulate	 v.  模仿， 假装
tenet	 n.  信条， 原则
phase	 n.  阶段
laurel	 n.  月桂树； 荣誉
dilute	 v.  冲淡， 稀释
culpability	 n.  有罪， 有过失
inability	 n. 无才能，无能力todo
ethnic	 adj.  种族的， 民族的
efficiency	 n.  效率， 功效
antibody	 n.  抗体
inconclusive	 adj.  非决定性的， 无结果的
unconfined	 adj.  未予限制的， 自由的
contract	 v.  感染； 收缩 n.  合同， 契约
conclude	 v.  推断， 做结论
profitable	 adj.  有利可图的
sluggish	 adj.  缓慢的
answerable	 adj.  应负责的
iconography	 n.  肖像； 图像
comprehension	 n.  理解； 包含
susceptible	 adj.  易受影响的； 敏感的
invariant	 adj.  不变的
innovative	 adj.  革新的
insight	 n.  洞察力， 见识
intact	 adj.  完整的， 未动过的
quiescent	 adj.  静止的
fabric	 n.  织物； 构造
revolutionary	 adj.  革命的； 革命性的
handlebar	 n.  手把
juvenile	 adj.  青少年的
pervasive	 adj.  普遍的， 流行的
managerial	 adj.  管理的
status quo ante	 原状；以前的状况
alligator	 n.  短吻鳄
localize	 v.  使地方化； 局部化
mural	 n.  壁画
sympathetic	 adj.  同情的； 赞同的
aspersion	 n.  诽谤， 中伤
insignificant	 adj.  无价值的， 无意义的， 无用的
seasonal	 adj.  季节的； 周期性的
periodic	 adj.  周期的， 定期的
complacency	 n.  自满， 自得
pelvis	 n.  骨盆
conscription	 n.  征兵， 征募
aurora	 n.  极光
distribution	 n.  分布； 分配
sedentary	 adj.  久坐的； 需长坐的
derive	 v.  得到， 得自； 推论出
unreimbursed	 adj.  未偿还
capacity	 n.  最大容量； 最大生产量； 能力
inescapable	 adj.  不可避免的； 逃脱不了的
undeterred	 adj.  未受阻的
confess	 v.  承认， 供认
counterfeit	 v.  伪造， 仿造 n. 赝品；
flat	 adj. 平滑的；统一的；固定的； n.  公寓
assert	 v.  断言； 声称
recall	 v. 回忆； n.  收回
alumna	 n. 女校友， 女毕业生
fatality	 n.  死亡
precise	 adj.  准确的， 精确的； 严谨的
sprinkler	 n.  洒水装置； 消防喷嘴
interlude	 n.  插入的时期或事件
sensible	 adj.  明智的
objection	 n.  厌恶， 反对
dispute	 v. 争论； n.  争辩
observation	 n.  观测； 遵守； 观察报告
entrapment	 n.  诱捕的行动
enamel	 v.  彩饰 n. 牙釉质；搪瓷；
rugged	 adj.  高低不平的， 崎岖的
aggression	 n.  侵略， 侵犯； 敌对行为
suspect	 v.  怀疑； 推测 n.  嫌疑犯
infuse	 v.  灌输
fraction	 n.  片段； 小部分； 分数
filter	 n. 过滤器 v. 过滤
monopolistic	 adj.  垄断的； 独占性的； 专利的
cease	 v&n.  终止， 停止
referral	 n.  推荐， 提及
perceptibly	 adv.  可察觉地， 可辨地
assess	 v.  估计； 评价
prescription	 n.  药方； 指示； 惯例
unravel	 v.  解开， 拆散
spectator	 n.  观众； 旁观者
edible	 adj.  可食用的 n. 食品；
asset	 n.  资产， 财产
minimum	 adj.  最低的 n. 最小值；
scarce	 adj.  缺乏的； 稀有的
cranium	 n.  头颅； 头盖
obsess	 v.  困扰， 着迷
blot	 v.  模糊， 遮暗 n. 墨迹，污迹；
categorical	 adj.  无条件的， 绝对的； 分类的
filibuster	 n.  阻挠议案通过； 妨碍议事
incipient	 adj.  初期的， 刚出现的
reveal	 v.  启示； 揭露 publicly or generally known)； 显示(to open up to view)
theoretical	 adj.  不切实际的； 理论的
harbor	 v.  庇护 n. 海港，避难所；
hospitable	 adj.  热情友好的； 宜人的
declension	 n.  衰退
cork	 n.  软木塞； 软木制品
tremendous	 adj.  惊人的； 巨大的
logotype	 n.  标志
escalate	 v.  迅速增加
condense	 v.  使冷凝， 浓缩； 缩短
barrier	 n.  栅栏；  障碍， 壁垒
revitalize	 v.  新生， 得到复兴
substantiate	 v.  证实， 证明
caribou	 n.  北美驯鹿
corral	 v.  关进畜栏 n. 畜栏；
partisan	 adj.  有偏见的
fertilized	 adj.  已受精的
bearer	 n.  搬运工； 生育者
pantheon	 n.  万神殿； 伟人祠
indistinct	 adj.  模糊的， 朦胧的； 难以清楚辨认的
tenure	 n.  任期； 保有权
mileage	 n.  英里数； 英里里程
activist	 n.  积极分子
tap	 v.  轻敲； 轻拍 n. 水龙头；
individual	 adj. 单独的，个人的； n.  个人， 个体
indirect	 adj.  间接的； 迂回的
maxim	 n.  格言
nuisance	 n.  讨厌的人； 麻烦事
brace	 v.  准备 n. 支柱，支撑；
prolonged	 adj.  延长的； 拖延的； 持续很久的
prestige	 n.  威信， 声望
suffrage	 n.  选举权， 投票权
activism	 n.  行动主义； 激进主义
bloc	 n.  集团， 组织
cord	 n.  绳， 索； 【解】 索状组织
putty	 n.  油灰； 易被摆布的人
council	 n.  理事会， 委员会
testimony	 n.  证词
retaliation	 n.  报复
anatomical	 adj.  解剖学的
enforce	 v.  实施， 执行
rectangle	 n.  长方形， 矩形
rotational	 adj.  转动的； 轮流的
departure	 n.  离开； 出发
fragile	 adj.  脆的， 易碎的； 脆弱的
gadgeteering	 n.  精妙的机器发明
painstaking	 adj.  辛勤的； 费力的
concrete	 adj. 具体的，有形的； n.  混凝土
note	 v.  注意； 指出 n. 记录；音符；
ancestry	 n.  祖先； 世系， 血统
penalty	 n.  处罚； 罚款
exile	 v&n.  放逐， 流放
distinct	 adj.  不同的， 有差别的
scale	 n.  鳞片； 规模； 等级
forage	 v.  搜寻， 翻寻 n. 饲料，粮草；
vegetation	 n.  植被)
nomadic	 adj.  游牧的
hedge	 v.  围困； 限制
restructure	 v.  调整， 重建； 更改结构
inclusion	 n.  包含； 内含物
contributor	 n.  贡献者， 捐助者； 投稿者
salient	 adj.  显著的， 突出的
purport	 v.  声称 n.  意图
eligible	 adj.  合格的， 符合条件的
paternalism	 n.  家长式统治； 家长主义
glacier	 n.  冰河， 冰川
shimmer	 v.  使闪烁， 发闪烁的微光 n. 微光，闪光；
herd	 v.  放牧 n. 兽群；牧群；
shrill	 adj.  尖锐的； 刺耳的
prose	 n.  散文
unconscious	 adj.  不省人事的； 未发觉的， 未意识到的
salinity	 n.  盐度， 盐分
oats	 n.  燕麦； 燕麦片
orientation	 n.  方向， 取向， 目标
racism	 n.  种族歧视； 种族主义
motion	 n.  运动； 提议
idle	 adj.  闲置的； 无用的； 懒散的
implementation	 n.  实现； 履行
cuisine	 n.  烹饪， 烹调法
fault	 n.  过错； 【地】 断层
arbitrary	 adj.  任意的， 主观的
standardize	 v.  使标准化； 用标准检验
hail	 v.  向…欢呼 n. 冰雹；
intent	 adj.  专心的； 急切的 n. 意图，目的；
passive	 adj.  被动的， 消极的
fertilizer	 n.  肥料， 化肥
efficacy	 n.  功效， 效力
monsoon	 n.  季风； 雨季
beckon	 v.  召唤； 吸引， 引诱
fragment	 n.  碎片； 部分
corresponding	 adj.  相当的； 一致的； 通信的
granite	 n.  花岗岩
divest	 v.  摆脱； 剥夺
treaty	 n.  协议， 条约
responsive	 adj.  有反应的； 反应迅速的， 敏感的
unearth	 v.  出土
emit	 v.  放射
category	 n.  类别， 种类
rival	 adj. 竞争的； v.  比得上 n. 竞争者；可与匹敌的人；
underwriter	 n.  保险公司， 保险业者； 担保人
overcapitalize	 v.  过分投资于
snap	 v.  猛咬 n. 摁扣；
