pharmacy	 n. 药房；配药学，药剂学；制药业；一批备用药品
toilsome	 adj. 辛苦的；劳苦的；费力的
efface	 v. 抹去，抹掉；使自己不受人注意
plastic	 adj. 塑料的；（外科）造型的；可塑的 n. 塑料制品；整形；可塑体
advocacy	 n. 主张；拥护；辩护
clutter	 n. 杂乱，混乱 v. 使凌乱；胡乱地填满
profession	 n. 职业，专业；声明，宣布，表白
parsimonious	 adj. 吝啬的；过于节俭的；质量差的
Phosphorus	 n. 磷
bravo	 n. 喝彩；亡命徒 v. 喝彩 int. 好极了
alkali	 n. 碱；可溶性无机盐 adj. 碱性的
augment	 v. 增加；增大 n. 增加；增大
quarrelsome	 adj. 喜欢吵架的；好争论的
upheave	 v. 鼓起；举起；使隆起
unaccountable	 adj. 无责任的；莫名其妙的；不可理解的
surmise	 v. 猜测；推测 n. 推测；猜度
celebrity	 n. 名人；名声
laborious	 adj. 勤劳的；艰苦的；费劲的
petulant	 adj. 暴躁的；任性的；难以取悦的
volant	 adj. 迅速的；会飞的；飞行的 n. (Volant)人名；(法)沃朗
degenerate	 v. 使退化；恶化 adj. 退化的；堕落的 n. 堕落的人
chimerical	 adj. 空想的，妄想的；荒唐的
slope	 n. 斜坡；倾斜；斜率；扛枪姿势 v. 倾斜；逃走
scathe	 vt. 损伤；损害 n. 损伤；危害；损害
generation	 n. 一代；产生；一代人；生殖
brigade	 n. 旅；大部队；队列 v. 把…编成旅；把…编成队
alternate	 v. 交替；轮流 adj. 交替的；轮流的 n. 替换物
triennial	 adj. 每三年的；连续三年的 n. 三年生植物
impugn	 v. 指责，非难；抨击；反驳；对…表示怀疑
altimeter	 n. 测高仪，高度计
orthodoxy	 n. 正统；正教；正统说法
gasoline	 n. 汽油
hindrance	 n. 障碍；妨碍；妨害；阻碍物
flaunt	 v. 炫耀；飘扬 n. 炫耀；飘扬；招展
evolution	 n. 演变；进化论；进展
toll	 n. 通行费；代价；钟声；伤亡人数 v. 征收；敲钟
assertive	 adj. 肯定的；独断的；坚定而自信的
median	 n. n中值，中位数；三角形中线；梯形中位线 adj. 中值的；中央的
salient	 adj. 显著的；突出的；跳跃的 n. 凸角；突出部分
constructive	 adj. 建设性的；推定的；构造上的；有助益的
anathema	 n. 诅咒；革出教门；被诅咒者；令人厌恶的人
retrograde	 adj. 倒退的；退化的；次序颠倒的 v. 逆行；倒退；退步 adv. 倒退地；向后地
wherever	 adv. 无论什么地方；究竟在哪里 conj. 无论在哪里；无论什么情况下
effeminate	 adj. 柔弱的；女人气的 n. 女子气的男人 vt. 使柔弱；使无男子汉气概 vi. 变得无男子汉气概；变得柔弱
torrid	 adj. 晒热的；热情的
dynamic	 adj. 动态的；动力的；动力学的；有活力的 n. 动态；动力
resignation	 n. 辞职；放弃；辞职书；顺从
literacy	 n. 读写能力；精通文学
dissipate	 v. 浪费；使…消散
imaginary	 adj. 虚构的，假想的；想像的；虚数的
symptomatic	 adj. 有症状的；症候的
purposeful	 adj. 有目的的；有决心的
pervade	 v. 遍及；弥漫
aesthetic	 adj. 美的；美学的；审美的，具有审美趣味的
caustic	 adj. [化学] 腐蚀性的；[化学] 苛性的；刻薄的；焦散的 n. [助剂] 腐蚀剂；苛性钠；焦散曲线
timer	 n. [电子] 定时器；计时器；计时员，记时员；跑表；延时调节器
helix	 n. 螺旋，螺旋状物；[解剖] 耳轮
advantageous	 adj. 有利的；有益的
lucrative	 adj. 有利可图的，赚钱的；合算的
canonical	 adj. 依教规的；权威的；牧师的 n. 牧师礼服
guise	 n. 伪装；装束；外观 vt. 使化装 vi. 伪装
censorship	 n. 审查制度；审查机构
illegal	 adj. [法] 非法的；违法的；违反规则的 n. 非法移民，非法劳工
consultant	 n. 顾问；咨询者；会诊医生
burgeon	 n. 芽, 嫩枝 v. 萌芽, 发芽
automaton	 n. 自动机；机器人；自动机器
analyze	 v. 对…进行分析，分解（等于analyse）
resonate	 v. 共鸣；共振
safeguard	 n. [安全] 保护；保卫；保护措施 v. [安全] 保护，护卫
rectify	 v. 改正；精馏；整流
debut	 n. 初次登台；开张 v. 初次登台
braze	 v. 用黄铜制；使成黄铜色 n. 铜焊
pestilence	 n. 瘟疫（尤指鼠疫）；有害的事物
medieval	 adj. 中世纪的；原始的；仿中世纪的；老式的
suspend	 v. 延缓，推迟；使暂停；使悬浮
demolition	 n. 拆除（等于demolishment）；破坏；毁坏
soliloquy	 n. 独白；自言自语
exemplary	 adj. 典范的；惩戒性的；可仿效的
paradigm	 n. 范例；词形变化表
dilate	 v. 扩大；膨胀；详述
entity	 n. 实体；存在；本质
pecuniary	 adj. 金钱的；应罚款的
grandiose	 adj. 宏伟的；堂皇的；浮夸的；宏大的
censorious	 adj. 挑剔的；受批判的（名词censoriousness，副词censoriously）
atypical	 adj. 非典型的；不合规则的
gastronomy	 n. 烹饪法，美食法；享乐主义
witticism	 n. 妙语；名言；俏皮话
enumerate	 v. 列举；枚举；计算
echo	 v. 反射；重复 n. 回音；效仿
qualification	 n. 资格；条件；限制；赋予资格
invalid	 adj. 无效的；有病的；残废的 n. 病人；残废者 v. 使伤残；使退役
antediluvian	 adj. 大洪水前的；远古的；陈旧的；旧式的 n. 大洪水以前的人；年迈的人；不合时宜的人
moratorium	 n. 暂停，中止；[金融] 延期偿付
provocative	 adj. 刺激的，挑拨的；气人的 n. 刺激物，挑拨物；兴奋剂
undulate	 v. 起伏，波动；震动；呈波浪形 adj. 波动的；起伏的；波浪形的
salvage	 n. 打捞；海上救助；抢救财货；救难的奖金 v. 抢救；海上救助
gourmet	 n. 美食家 adj. 菜肴精美的
reciprocal	 adj. 互惠的；相互的；倒数的，彼此相反的 n. [数] 倒数；互相起作用的事物
adulatory	 adj. 阿谀的，奉承的；谄媚的
append	 v. 附加；贴上；盖章 n. 设置数据文件的搜索路径
rationalize	 v. 使……合理化；使……有理化；为……找借口
assay	 n. 化验；试验 v. 分析；化验；尝试
renovate	 v. 更新；修复；革新；刷新
leisure	 n. 闲暇；空闲；安逸 adj. 空闲的；有闲的；业余的
churlish	 adj. 没有礼貌的；脾气暴躁的
sermonize	 v. 说教；布道
incandescent	 adj. 辉耀的；炽热的；发白热光的
quadrant	 n. 象限；[海洋][天] 象限仪；四分之一圆
canine	 adj. 犬的；犬齿的；犬科的；似犬的 n. 犬；[解剖] 犬齿
seminar	 n. 讨论会，研讨班
veracity	 n. 诚实；精确性；老实；说真实话
disrepute	 n. 不光彩，坏名声
column	 n. 纵队，列；专栏；圆柱，柱形物
deduce	 v. 推论，推断；演绎出
contradict	 v. 反驳；否定；与…矛盾；与…抵触
effulgence	 n. 灿烂；光辉
votary	 n. 崇拜者；出家人 adj. 立誓任圣职的；誓约的
sparse	 adj. 稀疏的；稀少的
inveterate	 adj. 根深的；积习的；成癖的
indicator	 n. 指示器；[试剂] 指示剂；[计] 指示符；压力计
ray	 n. 射线；光线；【鱼类】鳐形目(Rajiformes)鱼 v. 放射；显出
aristocrat	 n. 贵族
deduct	 v. 扣除，减去；演绎
disturb	 v. 打扰；妨碍；使不安；弄乱；使恼怒
discord	 n. 不和；不调和；嘈杂声 v. 不一致；刺耳
brightness	 n. [光][天] 亮度；聪明，活泼；鲜艳；愉快
pusillanimous	 adj. 胆怯的；懦弱的；优柔寡断的
ruthless	 adj. 无情的，残忍的
mordacious	 adj. 锐利的；辛辣的
quantum	 n. 量子论；额；美国昆腾公司（世界领先的硬盘生产商）
bravado	 n. 虚张声势；冒险
tawdry	 adj. 非常华丽的；廉价而俗丽的 n. 俗丽的东西；廉价而俗丽之物
supplement	 v. 增补，补充 n. 增补，补充；补充物；增刊，副刊
aqueous	 adj. 水的，水般的
espy	 v. 看到；认出；发现 n. (Espy)人名；(英、法)埃斯皮
lament	 n. 挽歌；恸哭；悲痛之情 v. 哀悼；悲叹；悔恨
hinder	 v. 成为阻碍 adj. 后面的 n. (Hinder)人名；(芬)欣德
admonish	 v. 告诫；劝告
dominate	 v. 控制；支配；占优势；在…中占主要地位
vacillate	 v. 犹豫；踌躇；摇摆
proportionate	 adj. 成比例的；相称的；适当的 vt. 使成比例；使相称
conformity	 n. 一致，适合；符合；相似
axis	 n. 轴；轴线；轴心国
misrepresent	 v. 歪曲，误传；不合适地代表
conductor	 n. 导体；售票员；领导者；管理人
travail	 n. 分娩的痛苦；艰苦劳动 v. 辛勤努力；经受分娩的阵痛
inefficacious	 adj. 无用的；无效果的
excrement	 n. 粪便，排泄物
magnitude	 n. 大小；量级；[地震] 震级；重要；光度
orthodox	 adj. 正统的；传统的；惯常的；东正教的 n. 正统的人；正统的事物
colleague	 n. 同事，同僚
assignee	 n. 代理人；受托人；分配到任务的人
brittle	 adj. 易碎的，脆弱的；易生气的
assertion	 n. 断言，声明；主张，要求；坚持；认定
confront	 v. 面对；遭遇；比较
peruse	 v. 详细考察；精读
deport	 v. 驱逐出境；举止；放逐 n. (Deport)人名；(捷)德波特；(法)德波尔
ludicrous	 adj. 滑稽的；荒唐的
advantage	 n. 优势；利益；有利条件 v. 获利
rag	 n. 破布；碎屑 v. 戏弄；责骂
amusement	 n. 消遣，娱乐；乐趣
intermittent	 adj. 间歇的；断断续续的；间歇性
exhaust	 v. 排出；耗尽；使精疲力尽；彻底探讨 n. 排气；废气；排气装置
suspicious	 adj. 可疑的；怀疑的；多疑的
regress	 v. 逆行，倒退；复归 n. 回归；退回
souvenir	 n. 纪念品；礼物 vt. 把…留作纪念
recumbent	 adj. 斜倚的；休息的
neural	 adj. 神经的；神经系统的；背的；神经中枢的 n. (Neural)人名；(捷)诺伊拉尔
amateur	 n. 爱好者；业余爱好者；外行 adj. 业余的；外行的
sealant	 n. [机] 密封剂
subside	 v. 平息；减弱；沉淀；坐下
haste	 n. 匆忙；急忙；轻率 vi. 匆忙；赶紧 vt. 赶快
numeration	 n. 计算；数字的读法；[数] 命数法；编号
depraved	 adj. 堕落的；腐化的；卑鄙的 v. 使腐化（deprave的过去式和过去分词）
zeal	 n. 热情；热心；热诚
preamble	 n. 序文；电报报头；先兆 v. 作序文
testimonial	 n. 证明书；推荐书 adj. 证明的；褒奖的；表扬的
upturn	 n. 情况好转 vt. 使……转朝上；翻转 vi. 向上
alight	 v. 下来；飞落 adj. 烧着的；点亮着的
indiscriminate	 adj. 任意的；无差别的；不分皂白的
rationality	 n. 合理性；合理的行动
sterling	 adj. 纯正的；英币的；纯银制的 n. 英国货币；标准纯银
element	 n. 元素；要素；原理；成分；自然环境
obstinate	 adj. 顽固的；倔强的；难以控制的
writhe	 v. 翻滚；蠕动 n. 翻滚；扭动；苦恼
embody	 v. 体现，使具体化；具体表达 n. (Embody)人名；(英)恩博迪
ascetic	 adj. 苦行的；禁欲主义的 n. 苦行者；禁欲者
equilibrium	 n. 均衡；平静；保持平衡的能力
dominant	 adj. 显性的；占优势的；支配的，统治的 n. 显性
rob	 v. 抢劫；使…丧失；非法剥夺
recant	 v. 宣布放弃；公开认错
interpreter	 n. 解释者；口译者；注释器
verification	 n. 确认，查证；核实
brusque	 adj. 唐突的；直率的；无礼的 n. (Brusque)人名；(法)布吕斯克
dissect	 v. 切细；仔细分析
branch	 v. 分支；出现分歧 n. 树枝，分枝；分部；支流
cathode	 n. 阴极（电解）
turmoil	 n. 混乱，骚动
mandate	 n. 授权；命令，指令；委托管理；受命进行的工作 v. 授权；托管
trivial	 adj. 不重要的，琐碎的；琐细的
lugubrious	 adj. 悲哀的，悲惨的
space	 n. 空间；太空；距离 v. 留间隔
rationalism	 n. 理性主义；唯理主义
epitaph	 n. 碑文，墓志铭
resilience	 n. 恢复力；弹力；顺应力
cognate	 adj. [地质] 同源的；同类的 n. 同族；同根词
winsome	 adj. 迷人的；可爱的；引人注目的
appellation	 n. 称呼；名称；名目
agitation	 n. 激动；搅动；煽动；烦乱
unanimity	 n. 同意，全体一致
commotion	 n. 骚动；暴乱
astute	 adj. 机敏的；狡猾的，诡计多端的
pepsin	 n. 胃蛋白酶
retort	 n. 反驳，顶嘴；曲颈瓶 v. 反驳，反击
subconscious	 adj. 潜意识的；下意识的 n. 潜在意识；下意识心理活动
enormous	 adj. 庞大的，巨大的；凶暴的，极恶的
foster	 v. 培养；养育，抚育；抱（希望等） adj. 收养的，养育的 n. (Foster)人名；(英、捷、意、葡、法、德、俄、西)福斯特
ethereal	 adj. 优雅的；轻飘的；缥缈的；超凡的
irresolute	 adj. 优柔寡断的；踌躇不定的；无决断的
convoke	 v. 召集；召集…开会
codicil	 n. 遗嘱的附录
reserved	 adj. 保留的，预订的；缄默的，冷淡的，高冷的；包租的
morose	 adj. 郁闷的；孤僻的
drowsy	 adj. 昏昏欲睡的；沉寂的；催眠的
gibberish	 n. 乱语；快速而不清楚的言语
dogmatist	 n. 教条主义者；独断家；独断论者
alien	 adj. 外国的；相异的，性质不同的；不相容的 n. 外国人，外侨；外星人 v. 让渡，转让
cartographer	 n. 制图师；地图制作者
embitter	 v. 使怨恨；使难受；使受苦
obtrusive	 adj. 突出的；强迫人的；冒失的
emulate	 v. 仿真；模仿；尽力赶上；同…竞争 n. 仿真；仿效
regale	 v. 取悦；盛情款待 n. 款待
innumerable	 adj. 无数的，数不清的
calorie	 n. 卡路里（热量单位）
nemesis	 n. 报应；给与惩罚的人；天罚
conundrum	 n. 难题；谜语
whine	 v. 发牢骚；哭诉；嘎嘎响；发呜呜声 n. 抱怨；牢骚；哀鸣
incriminate	 v. 控告；暗示有罪
extinction	 n. 灭绝；消失；消灭；废止
penalty	 n. 罚款，罚金；处罚
vigilance	 n. 警戒，警觉；警醒症
analyst	 n. 分析者；精神分析医师；分解者
joint	 n. 关节；接缝；接合处，接合点；（牛，羊等的腿）大块肉 adj. 共同的；连接的；联合的，合办的 v. 连接，贴合；接合；使有接头
furtive	 adj. 鬼鬼祟祟的，秘密的
authentic	 adj. 真正的，真实的；可信的
contract	 v. 收缩；感染；订约 n. 合同；婚约
philosophy	 n. 哲学；哲理；人生观
defiant	 adj. 挑衅的；目中无人的，蔑视的；挑战的
uphold	 v. 支撑；鼓励；赞成；举起
infringe	 v. 侵犯；违反；破坏
genome	 n. 基因组；染色体组
equestrian	 adj. 马的；骑马的；骑术的 n. 骑手；骑马者
stationary	 adj. 固定的；静止的；定居的；常备军的 n. 不动的人；驻军
imitate	 v. 模仿，仿效；仿造，仿制
tangent	 adj. 切线的，相切的；接触的；离题的 n. [数] 切线，[数] 正切
vain	 adj. 徒劳的；自负的；无结果的；无用的
interference	 n. 干扰，冲突；干涉
violent	 adj. 暴力的；猛烈的
quotation	 n. [贸易] 报价单；引用语；引证
impurity	 n. 杂质；不纯；不洁
elevated	 adj. 提高的；高尚的；严肃的；欢欣的 v. 提高；抬起；振奋；提拔（elevate的过去分词） n. 高架铁路
polish	 n. 磨光，擦亮；擦亮剂；优雅，精良 v. 擦亮，变光滑 adj. 波兰的
decay	 v. 衰退，[核] 衰减；腐烂，腐朽 n. 衰退，[核] 衰减；腐烂，腐朽
disciple	 n. 门徒，信徒；弟子
grip	 n. 紧握；柄；支配；握拍方式；拍柄绷带 v. 紧握；夹紧
prepossessing	 adj. 给人好感的；有魅力的；引人注意的 v. 预先影响；使先具有（prepossess的现在分词）
besmear	 v. 弄脏，涂抹；玷污
recourse	 n. 求援，求助；[经] 追索权；依赖；救生索
repudiate	 v. 拒绝；否定；批判；与…断绝关系；拒付
centenary	 n. 一百年；百年纪念 adj. 一百年的
assailant	 n. 攻击者 adj. 袭击的；攻击的
brigand	 n. 强盗；土匪；盗贼
jeopardize	 v. 危害；使陷危地；使受危困
sanctimonious	 adj. 假装虔诚的；假装圣洁的；假装诚实的
errant	 adj. 不定的；周游的；错误的；偏离正路的
alias	 n. 别名，化名 adv. 别名叫；化名为
predation	 n. 捕食；掠夺
drub	 v. 用棒打；硬灌；打击
abeyance	 n. 中止，停顿；归属待定，暂搁
patriotism	 n. 爱国主义；爱国心，爱国精神
pervasive	 adj. 普遍的；到处渗透的；流行的
instrument	 n. 仪器；工具；乐器；手段；器械
accede	 v. 加入；同意；就任
innocuous	 adj. 无害的；无伤大雅的
amphitheater	 n. 竞技场；[建] 圆形露天剧场；古罗马剧场
demeanor	 n. 风度；举止；行为
commodity	 n. 商品，货物；日用品
callous	 adj. 无情的；麻木的；硬结的；起老茧的 v. 使冷酷无情；使硬结；使生茧 n. 硬皮；老茧
countermand	 n. 取消；反对命令 v. 取消，撤消；下反对命令召回
slander	 v. 诽谤；造谣中伤 n. 诽谤；中伤
deride	 v. 嘲笑；嘲弄
sugar	 n. 糖；食糖；甜言蜜语 v. 加糖于；粉饰
replenish	 v. 补充，再装满；把…装满；给…添加燃料
recitation	 n. 背诵；朗诵；详述；背诵的诗
atrocity	 n. 暴行；凶恶，残暴
wield	 v. 使用；行使；挥舞
speculate	 v. 推测；投机；思索
wittingly	 adv. 有意地，存心地
maintain	 v. 维持；继续；维修；主张；供养
lucubration	 n. 刻苦钻研；苦心而成的著作
malediction	 n. 坏话，诅咒
vindicate	 v. 维护；证明…无辜；证明…正确
invidious	 adj. 诽谤的；不公平的；引起反感的；易招嫉妒的
melodious	 adj. 悦耳的；旋律优美的
fluid	 adj. 流动的；流畅的；不固定的 n. 流体；液体
insidious	 adj. 阴险的；隐伏的；暗中为害的；狡猾的
concurrent	 adj. 并发的；一致的；同时发生的 n. [数] 共点；同时发生的事件
appeal	 v. 呼吁，恳求；上诉；诉诸，求助；有吸引力，迎合爱好；（体育比赛中）诉诸裁判 n. 呼吁，请求；吸引力，感染力；上诉；诉诸裁判
derelict	 adj. 玩忽职守的；无主的；被抛弃了的 n. 遗弃物；玩忽职守者；被遗弃的人
despoil	 v. 掠夺，剥夺；夺取
derive	 v. 源于；得自；获得 n. (Derive)人名；(法)德里夫
nonplus	 n. 迷惑；困惑 v. 使困惑
charter	 v. 特许；包租；发给特许执照 n. 宪章；执照；特许状
futile	 adj. 无用的；无效的；没有出息的；琐细的；不重要的
undervalue	 v. 低估之价值；看轻
jaded	 adj. 厌倦的；疲倦不堪的 v. 厌倦（jade的过去分词）；变得疲倦；精疲力竭
omnivore	 n. [动] 杂食动物；不偏食的人
fuse	 v. 融合；熔化，熔融 n. 保险丝，熔线；导火线，雷管
nauseate	 v. 作呕；厌恶；产生恶感
distend	 v. 使…膨胀；使…扩张
superlative	 adj. 最高的；最高级的；过度的 n. 最高级；最好的人；最高程度；夸大话
scurrilous	 adj. 下流的；说话粗鄙恶劣的；无礼的
advocate	 v. 提倡，主张，拥护 n. 提倡者；支持者；律师
eliminate	 v. 消除；排除
posit	 v. 安置；假定 n. 假设；设想
artifice	 n. 诡计；欺骗；巧妙的办法
diabolical	 adj. 恶魔的
lively	 adj. 活泼的；生动的；真实的；生气勃勃的 n. (Lively)人名；(英)莱夫利
malicious	 adj. 恶意的；恶毒的；蓄意的；怀恨的
rue	 v. 后悔；悲伤 n. 芸香；后悔
vitiate	 v. 损害，弄坏；使无效；污染
superintend	 v. 监督；管理；主管；指挥
ancillary	 adj. 辅助的；副的；从属的 n. 助手；附件
odds	 n. 几率；胜算；不平等；差别
significant	 adj. 重大的；有效的；有意义的；值得注意的；意味深长的 n. 象征；有意义的事物
preordain	 v. 注定；预先决定
sagacious	 adj. 睿智的，聪慧的；有远见的，聪慧的
graduate	 v. 授予…学位；分等级；标上刻度 n. 研究生；毕业生 adj. 毕业的；研究生的
bibliophile	 n. 藏书家；爱书的人
autonomous	 adj. 自治的；自主的；自发的
conjugal	 adj. 婚姻的；结婚的；夫妻之间的
negligible	 adj. 微不足道的，可以忽略的
heedful	 adj. 注意的；深切注意的；深切留心的
scrutiny	 n. 详细审查；监视；细看；选票复查
retract	 v. 缩回；缩进；取消 n. 收缩核
sensitive	 adj. 敏感的；感觉的；[仪] 灵敏的；感光的；易受伤害的；易受影响的 n. 敏感的人；有灵异能力的人
sarcasm	 n. 讽刺；挖苦；嘲笑
bridle	 n. 缰绳；马勒；系带；约束物 v. 控制；给装马勒
transposition	 n. [数] 移项；调换；换置；变调
premonition	 n. 预告；征兆
paralysis	 n. 麻痹；无力；停顿
metabolism	 n. [生理] 新陈代谢
fretful	 adj. 焦躁的；烦燥的；起波纹的
dilapidate	 v. 毁坏；荒废；浪费
emergence	 n. 出现，浮现；发生；露头
belabor	 v. 痛打；抨击；过度说明；反复讨论
medium	 adj. 中间的，中等的；半生熟的 n. 方法；媒体；媒介；中间物
perverse	 adj. 堕落的，不正当的；倔强的；违反常情的
gland	 n. 腺
reliance	 n. 信赖；信心；受信赖的人或物
aviary	 n. 鸟类饲养场；大型鸟舍
panegyric	 n. 颂词，赞颂
obviate	 v. 排除；避免；消除
debilitate	 v. 使衰弱；使虚弱
biased	 adj. 有偏见的；结果偏倚的，有偏的
condone	 v. 宽恕；赦免
scruple	 n. 微量；顾虑；踌躇 v. 有顾忌；踌躇
wrest	 v. 用力拧；抢夺；歪曲 n. 扭，拧
infuse	 v. 灌输；使充满；浸渍
timbre	 n. [声] 音色；音质；音品
impute	 v. 归罪于，归咎于；嫁祸于
spineless	 adj. 没有骨气的；无脊椎的；懦弱的
infuriate	 v. 激怒；使大怒 adj. 狂怒的
emergency	 n. 紧急情况；突发事件；非常时刻 adj. 紧急的；备用的
unaffected	 adj. 不受影响的；自然的；真挚的；不矫揉造作的
bowler	 n. 圆顶礼帽；投球手；玩滚球的人
grasshopper	 n. 蚱蜢；[植保] 蝗虫；小型侦察机 vi. 见异思迁；蚱蜢似地跳
clandestine	 adj. 秘密的，私下的；偷偷摸摸的
pinnacle	 n. 高峰；小尖塔；尖峰；极点 v. 造小尖塔；置于尖顶上；置于高处
proclaim	 v. 宣告，公布；声明；表明；赞扬
gruff	 adj. 粗暴的；粗哑的；脾气坏的 vt. 粗鲁地说；生硬地说 vi. 粗鲁地说；生硬地说话 n. 格拉夫（英国珠宝品牌）
aptitude	 n. 天资；自然倾向；适宜
radiance	 n. 辐射；光辉；发光；容光焕发
deplore	 v. 谴责；悲悼；哀叹；对…深感遗憾
morality	 n. 道德；品行，美德
literary	 adj. 文学的；书面的；精通文学的
ion	 n. [化学] 离子
gesticulation	 n. 手势；姿势；示意动作
preeminence	 n. 卓越；杰出
clamorous	 adj. 吵闹的；大声要求的
enthrall	 v. 迷住，使着迷
complacent	 adj. 自满的；得意的；满足的
collaborate	 v. 合作；勾结，通敌
solicitude	 n. 焦虑；渴望；担心
prim	 adj. 拘谨的；整洁的；呆板的 v. 使显得一本正经；把…打扮得整整齐齐 n. (Prim)人名；(法、德、匈、捷、瑞典、西、葡)普里姆
aboriginal	 adj. 土著的；原始的 n. 土著居民；土生生物
soothe	 v. 安慰；使平静；缓和
elusive	 adj. 难懂的；易忘的；逃避的；难捉摸的
kiosk	 n. 凉亭；公用电话亭；报摊
discretionary	 adj. 任意的；自由决定的
gallop	 n. 疾驰；飞奔 v. 飞驰；急速进行；急急忙忙地说
flux	 n. [流][机] 流量；变迁；不稳定；流出 v. 使熔融；用焊剂处理
repulse	 v. 拒绝；驱逐；憎恶 n. 拒绝；击退
spheroid	 n. 球状体；回转椭球体
dominance	 n. 优势；统治；支配
insure	 v. 确保，保证；给…保险
assimilate	 v. 吸收；使同化；把…比作；使相似
dismissal	 n. 解雇；免职
irk	 v. 使烦恼；使厌倦
acute	 adj. 严重的，[医] 急性的；敏锐的；激烈的；尖声的
Oxygen	 n. [化学] 氧气，[化学] 氧
breach	 n. 违背，违反；缺口 v. 违反，破坏；打破
pursue	 v. 继续；从事；追赶；纠缠
suasion	 n. 说服，劝告
accessory	 n. 配件；附件；[法] 从犯 adj. 副的；同谋的；附属的
commentary	 n. 评论；注释；评注；说明
repository	 n. 贮藏室，仓库；知识库；智囊团
terrestrial	 adj. 地球的；陆地的，[生物] 陆生的；人间的 n. 陆地生物；地球上的人
strenuous	 adj. 紧张的；费力的；奋发的；艰苦的；热烈的
atrocious	 adj. 凶恶的，残暴的
adoration	 n. 崇拜；爱慕
corroborate	 v. 证实；使坚固
successive	 adj. 连续的；继承的；依次的；接替的
plague	 n. 瘟疫；灾祸；麻烦；讨厌的人 v. 折磨；使苦恼；使得灾祸
methane	 n. [有化] 甲烷；[能源] 沼气
tremulous	 adj. 胆小的；战栗的；震颤的
ravine	 n. 沟壑，山涧；峡谷
counter	 n. 柜台；对立面；计数器；（某些棋盘游戏的）筹码 v. 反击，还击；反向移动，对着干；反驳，回答 adj. 相反的 adv. 反方向地；背道而驰地
differentiation	 n. 变异，[生物] 分化；区别
reign	 v. 统治；支配；盛行；君临 n. 统治；统治时期；支配
accompaniment	 n. 伴奏；伴随物
ire	 n. 忿怒 vt. 使发怒
charge	 n. 费用；电荷；掌管；控告；命令；负载 v. 使充电；使承担；指责；装载；对…索费；向…冲去
disdain	 n. 蔑视 v. 鄙弃
trajectory	 n. [物] 轨道，轨线；[航][军] 弹道
incomprehensible	 adj. 费解的；不可思议的；无限的
stultify	 v. 使变无效；使显得愚笨；使无价值
artistic	 adj. 艺术的；风雅的；有美感的
surfeit	 n. 过度；饮食过度；恶心（由于饮食过度所引起） v. 使饮食过度；使厌腻；使过度沉溺于
gloomy	 adj. 黑暗的；沮丧的；阴郁的
implausible	 adj. 难以置信的，不像真实的
espouse	 v. 支持；嫁娶；赞成；信奉
zero	 n. 零点，零度 num. 零
residue	 n. 残渣；剩余；滤渣
outgoing	 adj. 对人友好的，开朗的；出发的，外出的；即将离职的；乐于助人的 n. 外出；流出；开支 v. 超过；优于（outgo的ing形式）
litigant	 n. 诉讼当事人 adj. 诉讼的
apparition	 n. 幽灵；幻影；鬼怪；离奇出现的东西
chronological	 adj. 按年代顺序排列的；依时间前后排列而记载的
vapid	 adj. 无趣味的；无生气的；索然乏味的
stock	 n. 股份，股票；库存；血统；树干；家畜 adj. 存货的，常备的；平凡的 v. 进货；备有；装把手于…
reform	 n. 改革，改良；改正 v. 改革，革新；重新组成 adj. 改革的；改革教会的
fervent	 adj. 热心的；强烈的；炽热的；热烈的
bilateral	 adj. 双边的；有两边的
compelling	 adj. 引人注目的；强制的；激发兴趣的 v. 强迫；以强力获得（compel的ing形式）
dissentious	 adj. 争吵的；好争论的
bombard	 v. 轰炸；炮击 n. 射石炮
sebaceous	 adj. 分泌脂质的；脂肪的，脂肪质的；似油脂或皮脂的
elapse	 v. 消逝；时间过去 n. 流逝；时间的过去
productive	 adj. 能生产的；生产的，生产性的；多产的；富有成效的
polarize	 v. （使）极化；（使）偏振；（使）两极分化
ruddy	 adj. 红的；红润的 adv. 极度；非常 vt. 使变红 vi. 变红 n. (Ruddy)人名；(英)拉迪
sap	 n. [植] 树液；精力，元气；活力；坑道 v. 使衰竭，使伤元气；挖掘以破坏基础
philanthropic	 adj. 博爱的；仁慈的
visual	 adj. 视觉的，视力的；栩栩如生的
philanthropy	 n. 博爱，慈善；慈善事业
cant	 n. 斜面；伪善之言；黑话；角落 v. 倾斜；讲黑话 adj. 行话的；哀诉声的；假仁假义的
combination	 n. 结合；组合；联合；[化学] 化合
pulverize	 v. 粉碎；使成粉末；研磨
fulsome	 adj. 令人生厌的；过度的
mundane	 adj. 世俗的，平凡的；世界的，宇宙的
line	 n. 路线，航线；排；绳 v. 排成一行；划线于；以线条标示；使…起皱纹
jubilant	 adj. 欢呼的；喜洋洋的
afire	 adj. 燃烧的；着火的 adv. 燃烧着；着火地
fortunate	 adj. 幸运的；侥幸的；吉祥的；带来幸运的
apathy	 n. 冷漠，无兴趣，漠不关心；无感情
atone	 v. 赎罪；弥补；偿还
precaution	 n. 预防，警惕；预防措施 vt. 警惕；预先警告
reticent	 adj. 沉默的；有保留的；谨慎的
demure	 adj. 端庄的；娴静的；严肃的；假装正直的 n. (Demure)人名；(法)德米尔
symmetrical	 adj. 匀称的，对称的
revert	 v. 回复；重提；返祖遗传；归还 n. 恢复原状者
pile	 n. 堆；大量；建筑群 v. 累积；打桩于
disprove	 v. 反驳，证明…是虚假的
molecule	 n. [化学] 分子；微小颗粒，微粒
revocation	 n. 取消；撤回；废除
zenith	 n. 顶峰；顶点；最高点
robust	 adj. 强健的；健康的；粗野的；粗鲁的
embolden	 v. 使有胆量，使大胆
choleric	 adj. 易怒的；暴躁的；胆汁质的
machination	 n. 阴谋；诡计
revere	 v. 敬畏；尊敬；崇敬
encroach	 v. 蚕食，侵占
hallmark	 n. 特点；品质证明 v. 给…盖上品质证明印记；使具有…标志
quintessence	 n. 精华；典范；第五元素（被视为地、水、火、风以外之构成宇宙的元素）
chagrin	 n. 懊恼；委屈；气愤 v. 使…懊恼
zest	 n. 风味；热心；强烈的兴趣 v. 给…调味
arrange	 v. 安排；排列；整理
assemble	 v. 集合，聚集；装配；收集
cornea	 n. [解剖] 角膜
spate	 n. 洪水；一阵；大雨；突然迸发
agitate	 v. 摇动；骚动；使…激动
tour	 n. 旅游，旅行；巡回演出 v. 旅行，在……旅游；在……作巡回演出
blithesome	 adj. 愉快的
tout	 v. 兜售；招徕；刺探赛马情报 n. 侦查者；兜售者
anecdote	 n. 轶事；奇闻；秘史
cerebellum	 n. [解剖] 小脑
factious	 adj. 好捣乱的；好搞派系的；源于派别的
artistry	 n. 艺术性；工艺；艺术技巧；艺术效果；艺术工作
obdurate	 adj. 顽固的，执拗的；冷酷无情的
overcome	 v. 克服；胜过
iconoclast	 n. 偶像破坏者；提倡打破旧习的人
acceleration	 n. 加速，促进；[物] 加速度
poignant	 adj. 尖锐的；辛酸的；深刻的；切中要害的 n. (Poignant)人名；(法)普瓦尼昂
pungent	 adj. 辛辣的；刺激性的；刺鼻的；苦痛的；尖刻的
heat	 n. 高温；压力；热度；热烈 v. 使激动；把…加热
restitution	 n. 恢复；赔偿；归还
awry	 adj. 错误的；扭曲的 adv. 歪曲地；歪斜地；错误地
mordent	 n. 涟音；波音
dejected	 adj. 沮丧的，灰心的
upshot	 n. 结果，结局；要点
relegate	 v. 把降低到；归入；提交
narcissistic	 adj. 自恋的；自我陶醉的
intellectual	 adj. 智力的；聪明的；理智的 n. 知识分子；凭理智做事者
sloth	 n. 怠惰，懒惰；[脊椎] 树懒
heedless	 adj. 不注意的；不留心的
arboriculture	 n. 树木的培植/栽培
fulminate	 v. 爆炸；电闪；怒喝 n. 雷酸盐；烈性炸药
dwarf	 v. 变矮小 n. 侏儒，矮子 adj. 矮小的
resonance	 n. [力] 共振；共鸣；反响
retrace	 v. 追溯；折回；重描
dogged	 adj. 顽强的；顽固的 vt. 跟踪；尾随（dog的过去式）
diminutive	 adj. 小的，小型的，微小的 n. 爱称；指小词；身材极小的人
symmetry	 n. 对称（性）；整齐，匀称
facile	 adj. （言语或理论）轻率的，未经深思熟虑的
dissolve	 v. 使溶解；使分解；使液化 n. 叠化画面；画面的溶暗
repetition	 n. 重复；背诵；副本
stoic	 n. 斯多葛学派哲学家；禁欲主义者；恬淡寡欲的人，不以苦乐为意的人 adj. 坚忍的，苦修的；斯多葛派的；禁欲主义的
gross	 adj. 总共的；粗野的；恶劣的；显而易见的 v. 总共收入 n. 总额，总数
allegory	 n. 寓言
artless	 adj. 天真的；朴实的；无虚饰的
reciprocate	 v. 报答；互换；互给
virus	 n. [病毒] 病毒；恶毒；毒害
quarantine	 v. 检疫；隔离；使隔离 n. 检疫；隔离；检疫期；封锁
temporary	 adj. 暂时的，临时的 n. 临时工，临时雇员
superintendent	 n. 监督人；负责人；主管；指挥者
remiss	 adj. 怠慢的；迟缓的；不小心的
eclipse	 v. 使黯然失色；形成蚀 n. 日蚀，月蚀；黯然失色
equality	 n. 平等；相等；[数] 等式
virtu	 n. 古董；艺术品爱好
dramatic	 adj. 戏剧的；急剧的；引人注目的；激动人心的
reprimand	 n. 谴责；训斥；申诉 v. 谴责；训斥；责难
august	 adj. 威严的；令人敬畏的 n. 八月（简写为Aug）
immerse	 v. 沉浸；使陷入
suffrage	 n. 选举权；投票；参政权；代祷；赞成票
truculent	 adj. 好斗的；野蛮的；言词刻毒的
bailiff	 n. 法警；执行官；区镇的地方长官
indignant	 adj. 愤愤不平的；义愤的
paramount	 adj. 最重要的，主要的；至高无上的 n. 最高统治者
grievance	 n. 不满，不平；委屈；冤情
affectation	 n. 做作；矫揉造作；假装
neuron	 n. [解剖] 神经元，神经单位
savor	 v. 尽情享受；使有风味；加调味品于；品尝，欣赏 n. 滋味；气味；食欲
quagmire	 n. 沼泽，沼泽地；无法脱身的困境
unconscionable	 adj. 不合理的；昧着良心的；肆无忌惮的；过度的
posse	 n. 一队；民防团；地方武装团队
nutriment	 n. 营养物；促进生长的东西
bombast	 n. 夸大的言辞 adj. 夸大的
chateau	 n. （法国封建时代的）城堡；（尤指法国的）别墅
formula	 n. [数] 公式，准则；配方；婴儿食品
harass	 v. 使困扰；使烦恼；反复袭击
combustible	 adj. 易燃的；易激动的；燃烧性的 n. 可燃物；易燃物
purity	 n. [化学] 纯度；纯洁；纯净；纯粹
calamity	 n. 灾难；不幸事件
inhuman	 adj. 残忍的；野蛮的；无人性的
disavow	 v. 否认，否定；抵赖；拒绝对…的责任
diversify	 v. 使多样化，使变化；增加产品种类以扩大
amity	 n. 友好；亲善关系；友好关系
juncture	 n. 接缝；连接；接合
askew	 adj. 歪斜的 adv. 歪斜地，斜地 n. (Askew)人名；(英)艾斯丘
preface	 n. 前言；引语 v. 为…加序言；以…开始
arithmetic	 n. 算术，算法
cadenza	 n. 装饰乐段
memorize	 v. 记住，背熟；记忆
ingenious	 adj. 有独创性的；机灵的，精制的；心灵手巧的
waif	 n. 流浪者；流浪儿；飘流物；无主物；信号旗
collision	 n. 碰撞；冲突；（意见，看法）的抵触；（政党等的）倾轧
stanch	 v. 止血；使不漏；平息 adj. 坚固的；忠实的；防水的
prehensile	 adj. 适于抓握的；善于领会的
hodgepodge	 n. 大杂烩；混煮；一团糟 vt. 使混乱
ribald	 adj. 下流的；言谈粗俗的 n. 言谈粗俗的人；说下流话的人
undue	 adj. 过度的，过分的；不适当的；未到期的
biodegradable	 adj. 生物所能分解的，能进行生物降解的
saline	 adj. 盐的；含盐分的 n. 盐湖；碱盐泻药
recombination	 n. 复合，再结合；[遗] 重组
preferential	 adj. 优先的；选择的；特惠的；先取的
vulnerable	 adj. 易受攻击的，易受…的攻击；易受伤害的；有弱点的
digit	 n. 数字；手指或足趾；一指宽
antipathy	 n. 反感；厌恶；憎恶；不相容
carnal	 adj. 肉体的；肉欲的；淫荡的；性欲的 n. (Carnal)人名；(西)卡纳尔
stealth	 n. 秘密；秘密行动；鬼祟
beaker	 n. 烧杯；大口杯
meddler	 n. 干涉者；爱管闲事的人
decent	 adj. 正派的；得体的；相当好的
transcendent	 adj. 卓越的；超常的；出类拔萃的 n. 卓越的人；超绝物
modulate	 v. 调节；（信号）调制；调整
untoward	 adj. 不幸的；麻烦的；倔强的；困难的
Iron	 n. 熨斗；烙铁；坚强 v. 熨；用铁铸成 adj. 铁的；残酷的；刚强的
acclaim	 v. 称赞；为…喝彩，向…欢呼 n. 欢呼，喝彩；称赞
adhere	 v. 坚持；依附；粘着；追随
fern	 n. [植] 蕨；[植] 蕨类植物
naive	 adj. 天真的,幼稚的
distraught	 adj. 发狂的；心烦意乱的
salacious	 adj. 好色的；猥亵的；淫荡的
supercilious	 adj. 目空一切的，高傲的；傲慢的，自大的
giraffe	 n. 长颈鹿
perspicuous	 adj. 明了的；清晰明白的；易懂的
donate	 v. 捐赠；捐献 n. 捐赠；捐献
skirt	 n. 裙子 v. 绕过，回避；位于…边缘
elicit	 v. 抽出，引出；引起
integer	 n. [数] 整数；整体；完整的事物
clergy	 n. 神职人员；牧师；僧侣
compliment	 n. 恭维；称赞；问候；致意；道贺 v. 恭维；称赞
unequivocal	 adj. 明确的；不含糊的
incredulous	 adj. 怀疑的；不轻信的
glimpse	 n. 一瞥，一看 v. 瞥见
soda	 n. 苏打；碳酸水
altruistic	 adj. 利他的；无私心的
pallid	 adj. 苍白的；暗淡的；无生气的
cession	 n. （权利的）转让，出让；（领土的）割让
adjuration	 n. 严令；恳请；立誓
forage	 n. 饲料；草料；搜索 v. 搜寻粮草；搜寻
erudite	 adj. 博学的；有学问的 n. 饱学之士
retouch	 n. 润饰；修整部分 v. 润饰；修整
conception	 n. 怀孕；概念；设想；开始
warrant	 n. 根据；证明；正当理由；委任状 v. 保证；担保；批准；辩解
body	 n. 身体；主体；大量；团体；主要部分 v. 赋以形体
trepidation	 n. 恐惧；惊恐；忧虑；颤抖
haggard	 adj. 憔悴的；野性的 n. 野鹰
egregious	 adj. 惊人的；过分的；恶名昭彰的
acclivity	 n. 向上的斜坡；[建] 上斜
virtuoso	 n. 艺术品鉴赏家；古董收藏家；艺术大师 adj. 行家里手的；艺术爱好者的
captious	 adj. 挑剔的；吹毛求疵的
adulate	 v. 过分称赞；谄媚；奉承
antenatal	 adj. 产前的；出生前的
solecism	 n. 语法错误，文理不通；谬误，失礼
semiconscious	 adj. 半意识的；半清醒的
perambulate	 v. 巡行；巡视；漫步
mishap	 n. 灾祸；不幸事故；晦气
butte	 n. 孤峰；孤立的丘
impromptu	 n. 即兴曲；即席演出 adv. 即席地 adj. 即席的
mystify	 v. 使神秘化；使迷惑，使困惑
frenzied	 adj. 疯狂的；狂乱的；激怒的 v. 使狂乱（frenzy的过去式）
ken	 n. 视野范围，见地，知识范围
counterpoint	 n. 复调；对位法；旋律配合；对应物
submerge	 v. 淹没；把…浸入；沉浸
derisive	 adj. 嘲笑的，嘲弄的；可付之一笑的
light	 n. 光；光线；灯；打火机；领悟；浅色；天窗 adj. 轻的；浅色的；明亮的；轻松的；容易的；清淡的 v. 点着；变亮；着火 adv. 轻地；清楚地；轻便地
key	 n. （打字机等的）键；关键；钥匙 v. 键入；锁上；调节…的音调；提供线索 adj. 关键的
coup	 n. 政变；妙计；出乎意料的行动；砰然的一击 vt. 使…颠倒；使…倾斜 vi. 推倒；倾斜；溢出
insulin	 n. [生化][药] 胰岛素
script	 n. 脚本；手迹；书写用的字母 v. 把…改编为剧本
measurement	 n. 测量；[计量] 度量；尺寸；量度制
scowl	 n. 愁容；怒容；阴沉沉的样子 v. 皱眉；怒视
receptive	 adj. 善于接受的；能容纳的
propellant	 n. 推进物；推进燃料；发射火药 adj. 推进的
comprise	 v. 包含；由…组成
typography	 n. 排印；[印刷] 活版印刷术；印刷格式
pedantic	 adj. 迂腐的；学究式的；卖弄学问的；假装学者的
diode	 n. [电子] 二极管
statuesque	 adj. 雕像般的；轮廓清晰的；均衡的
terminate	 v. 使终止；使结束；解雇 adj. 结束的
illustrious	 adj. 著名的，杰出的；辉煌的
set	 n. [数] 集合；一套；布景；[机] 装置 v. 树立；点燃；点缀； adj. 固定的；规定的；固执的
virtuous	 adj. 善良的；有道德的；贞洁的；正直的；有效力的
kinetic	 adj. [力] 运动的；活跃的
consensus	 n. 一致；舆论；合意
dictatorial	 adj. 独裁的，专政的；专横傲慢的
submersion	 n. 淹没，浸没
plural	 adj. 复数的 n. 复数
bursar	 n. 财务主管；会计员；领取奖学金的学生
assimilation	 n. 同化；吸收；[生化] 同化作用
enhance	 v. 提高；加强；增加
irascible	 adj. 易怒的
gratuity	 n. 赏钱，小费；赠物；[劳经] 退职金
instantaneous	 adj. 瞬间的；即时的；猝发的
naturalistic	 adj. 自然的；自然主义的；博物学的
suspension	 n. 悬浮；暂停；停职
tenuous	 adj. 纤细的；稀薄的；贫乏的
languish	 v. 憔悴；凋萎；失去活力；苦思
equanimity	 n. 平静；镇定
dimension	 n. 方面;[数] 维；尺寸；次元；容积 vt标出尺寸 adj. 规格的
recollect	 v. 回忆，想起
trammel	 v. 束缚；拘束；阻碍 n. 拘束；束缚；束缚物
peevish	 adj. 易怒的，暴躁的；带怒气的；撒娇的
cilia	 n. 纤毛；睫毛
outlaw	 n. 歹徒；罪犯；亡命之徒；被剥夺法律保护者 v. 宣布…为不合法；将…放逐；剥夺…的法律保护
camaraderie	 n. 友情；同志之爱
respiration	 n. 呼吸；呼吸作用
ancestry	 n. 祖先；血统
symphonious	 adj. 和谐的；调和的
punctuate	 v. 不时打断；强调；加标点于
indigence	 n. 穷困；贫乏；贫穷
cajole	 v. 以甜言蜜语哄骗；勾引
forsake	 v. 放弃；断念
mariner	 n. 水手；船员
bizarre	 adj. 奇异的（指态度，容貌，款式等）
saccharine	 adj. 含糖的；极甜的；和颜悦色的 n. （美）糖精
terse	 adj. 简洁的，精练的，扼要的
polemics	 n. 辩论术；论证法（polemic的复数）
retinue	 n. 随行人员；扈从
renaissance	 n. 文艺复兴（欧洲14至17世纪）
urbane	 adj. 彬彬有礼的，温文尔雅的；都市化的
ecstatic	 adj. 狂喜的；入迷的 n. 狂喜的人
gypsum	 vt. 用石膏处理；施石膏肥料于 n. 石膏；石膏肥料
apparatus	 n. 装置，设备；仪器；器官
embrace	 v. 拥抱；信奉，皈依；包含 n. 拥抱
inhibit	 v. 抑制；禁止
contradictory	 adj. 矛盾的；反对的；反驳的；抗辩的 n. 对立物；矛盾因素
prohibitive	 adj. 禁止的，禁止性的；抑制的；（费用，价格等）过高的；类同禁止的
vociferate	 v. 喊叫；大叫
archaeology	 n. 考古学
alimentary	 adj. 滋养的；食物的
credulity	 n. 轻信；易受骗
counteract	 v. 抵消；中和；阻碍
apogee	 n. 最高点，极点；远地点 vt. 位于远地点；位于最高点
rabid	 adj. 激烈的；狂暴的；偏激的；患狂犬病的
diurnal	 adj. 白天的；每日的，一日间的 n. 日记账；日报，日刊
emotion	 n. 情感；情绪
heteromorphic	 adj. [生物] 异形的，[生物] 异态的；[化学] 多晶型的
displace	 v. 取代；置换；转移；把…免职；排水
stripling	 n. 年轻人，小伙子
terrify	 v. 恐吓；使恐怖；使害怕
indolent	 adj. 懒惰的；无痛的
recriminate	 v. 反责；反唇相讥
apparent	 adj. 显然的；表面上的
perennial	 adj. 多年生的；常年的；四季不断的；常在的；反复的 n. 多年生植物
inimical	 adj. 敌意的；有害的
heterogeneity	 n. [生物] 异质性；[化学] 不均匀性；[化学] 多相性
nominate	 v. 推荐；提名；任命；指定
seclusion	 n. 隔离；隐退；隐蔽的地方
polar	 adj. 极地的；两极的；正好相反的 n. 极面；极线
scour	 v. 冲刷；擦；腹泻 n. 擦，冲刷；洗涤剂；（畜类等的）腹泻
stigma	 n. [植] 柱头；耻辱；污名；烙印；特征
refractory	 adj. 难治的；难熔的；不听话的 n. 倔强的人；耐火物质
disregard	 v. 忽视；不理；漠视；不顾 n. 忽视；不尊重
simultaneous	 adj. 同时的；联立的；同时发生的 n. 同时译员
levee	 n. 堤坝（码头）；（旧时君主或显贵的）早晨接见 vt. 为…筑堤
pollute	 v. 污染；玷污；败坏
prejudice	 n. 偏见；侵害 v. 损害；使有偏见
stern	 n. 船尾；末端 adj. 严厉的；坚定的
colloid	 adj. 胶质的 n. [物化] 胶质
admittance	 n. 进入；入场权；通道
ductile	 adj. 柔软的；易教导的；易延展的
divergent	 adj. 相异的，分歧的；散开的
triangle	 n. 三角（形）；三角关系；三角形之物；三人一组
detonate	 v. 使爆炸
occult	 adj. 神秘的；超自然的；难以理解的 v. 掩蔽 n. 神秘学
inchoate	 adj. 早期的；刚开始的；未充分发展的 vt. 开始 vi. 开始
placenta	 n. [胚] 胎盘；[植] 胎座
inconsistent	 adj. 不一致的；前后矛盾的
adhesion	 n. 粘附；支持；固定
taunt	 n. 嘲弄；讥讽 v. 奚落；逗弄 adj. 很高的
juxtaposition	 n. 并置，并列；毗邻
testament	 n. [法] 遗嘱；圣约；确实的证明
acquainted	 adj. 熟识的；知晓的；有知识的 v. 使了解（acquaint的过去分词）
inventive	 adj. 发明的；有发明才能的；独出心裁的
adversity	 n. 逆境；不幸；灾难；灾祸
erratic	 adj. 不稳定的；古怪的 n. 漂泊无定的人；古怪的人
reck	 vt. 顾虑；和…相干 vi. 介意；有关系 n. (Reck)人名；(英、德、匈、波)雷克
instruct	 v. 指导；通知；命令；教授
substantiate	 v. 证实；使实体化
centurion	 n. 百夫长；百人队队长
recuperate	 v. 恢复，复原；挽回损失
diagonal	 adj. 斜的；对角线的；斜纹的 n. 对角线；斜线
prehension	 n. 理解；抓住
effigy	 n. 雕像，肖像
neutrality	 n. 中立；中性；中立立场
competence	 n. 能力，胜任；权限；作证能力；足以过舒适生活的收入
rapine	 n. 掠夺；劫掠
appropriate	 adj. 适当的；恰当的；合适的 v. 占用，拨出
benignant	 adj. 良性的；仁慈的；有益的；和蔼的
overlap	 n. 重叠；重复 v. 部分重叠；部分的同时发生
premise	 v. 引出，预先提出；作为…的前提 n. 前提；上述各项；房屋连地基
outburst	 n. （火山、情感等的）爆发；破裂
usurious	 adj. 高利贷的
forthright	 adj. 直率的；直截了当的 adv. 直率地；马上；立即 n. 直路
inviolable	 adj. 不可侵犯的；神圣的；不可亵渎的
academy	 n. 学院；研究院；学会；专科院校
encyclopedia	 n. 百科全书（亦是encyclopaedia）
conventional	 adj. 符合习俗的，传统的；常见的；惯例的
intersect	 v. 相交，交叉
dearth	 n. 缺乏；饥馑；粮食不足
bridge	 n. 桥；桥牌；桥接器；船桥 v. 架桥；渡过
release	 v. 释放；发射；让与；允许发表 n. 释放；发布；让与
accolade	 n. 荣誉；荣誉称号授予仪式；连谱号；称赞
appreciate	 v. 欣赏；感激；领会；鉴别
equivalent	 adj. 等价的，相等的；同意义的 n. 等价物，相等物
nomadic	 adj. 游牧的；流浪的；游动的
scope	 n. 范围；余地；视野；眼界；导弹射程 v. 审视
erosion	 n. 侵蚀，腐蚀
organelle	 n. [细胞] 细胞器；细胞器官
mutation	 n. [遗] 突变；变化；元音变化
combustion	 n. 燃烧，氧化；骚动
adverse	 adj. 不利的；相反的；敌对的（名词adverseness，副词adversely）
achromatic	 adj. 消色差的；非染色质的；非彩色的
affiliate	 n. 联号；隶属的机构等 v. 使附属；接纳；使紧密联系
fungi	 n. 真菌；菌类；蘑菇（fungus的复数）
variegated	 adj. 杂色的；斑驳的；富于变化的 v. 成为杂色（variegate的过去式）
poverty	 n. 贫困；困难；缺少；低劣
stupor	 n. 昏迷，恍惚；麻木
inhume	 v. 埋葬；土葬
indifferent	 adj. 漠不关心的；无关紧要的；中性的，中立的
generator	 n. 发电机；发生器；生产者
evolve	 v. 发展，进化；进化；使逐步形成；推断出
abstract	 n. 摘要；抽象；抽象的概念 adj. 抽象的；深奥的 v. 摘要；提取；使……抽象化；转移(注意力、兴趣等)；使心不在焉
granule	 n. 颗粒
bauxite	 n. 矾土，[矿物] 铁铝氧石；[矿物] 铝土矿
bowdlerize	 v. 删改；删除不妥的文句
puissant	 adj. 强大的，强盛的；有势力的，有权力的 n. (Puissant)人名；(法)皮桑
shriek	 v. 尖叫；促人注意 n. 尖声；尖锐的响声
esteem	 v. 尊敬；认为；考虑；估价 n. 尊重；尊敬
diligent	 adj. 勤勉的；用功的，费尽心血的 n. (Diligent)人名；(法)迪利让
renunciation	 n. 放弃；脱离关系；拒绝承认；抛弃；弃权
propitious	 adj. 适合的；吉利的；顺利的
divisor	 n. 除数；因子
vile	 adj. 卑鄙的；邪恶的；低廉的；肮脏的 n. (Vile)人名；(英)瓦伊尔；(芬)维莱
eradicate	 v. 根除，根绝；消灭
everlasting	 adj. 永恒的；接连不断的
venerate	 v. 崇敬，尊敬
duration	 n. 持续，持续的时间，期间
benediction	 n. 祝福；赐福；恩赐；祈求上帝赐福的仪式
unconscious	 adj. 无意识的；失去知觉的；不省人事的；未发觉的
fossil	 n. 化石；僵化的事物；顽固不化的人 adj. 化石的；陈腐的，守旧的
digestion	 n. 消化；领悟
accursed	 adj. 被诅咒的；讨厌的；可憎的
constitute	 v. 组成，构成；建立；任命
volitive	 adj. 意志的；表示意志的；发自意志的
introspect	 v. 反省；内省
compound	 n. [化学] 化合物；混合物；复合词 adj. 复合的；混合的 v. 合成；混合；恶化，加重；和解，妥协
decorous	 adj. 有礼貌的，高雅的；端正的
redeem	 v. 赎回；挽回；兑换；履行；补偿；恢复
metabolic	 adj. 变化的；新陈代谢的
lucid	 adj. 明晰的；透明的；易懂的；头脑清楚的
quail	 v. 畏缩，胆怯；感到恐惧 n. 鹌鹑
neutralize	 v. 抵销；使…中和；使…无效；使…中立
torque	 n. 转矩，[力] 扭矩；项圈，金属领圈 v. (向轴、螺栓、圆轮等)施以扭动力；(使)沿轴转动；使(绕轴等)扭转；施加转矩
optimal	 adj. 最佳的；最理想的
wistful	 adj. 渴望的；沉思的，默想的；引起怀念的；不满足似的
playwright	 n. 剧作家
calumniate	 v. 诽谤；中伤；诬蔑
bustle	 v. 喧闹；忙乱；充满 n. 喧闹；活跃；裙撑；热闹的活动
conscientious	 adj. 认真的；尽责的；本着良心的；小心谨慎的
cerebration	 n. 思考；精神活动；脑髓作用
imperative	 adj. 必要的，不可避免的；紧急的；命令的，专横的；势在必行的；[语]祈使的 n. 必要的事；命令；需要；规则；[语]祈使语气
inspiration	 n. 灵感；鼓舞；吸气；妙计
befog	 v. 使困惑，使模糊；罩入雾中
equiangular	 adj. 等角的
acidify	 v. [化学] 酸化；变酸
avalanche	 n. 雪崩 v. 雪崩
homogeneous	 adj. 均匀的；[数] 齐次的；同种的；同类的，同质的
pugnacious	 adj. 好斗的，好战的
callosity	 n. 无情；老茧皮；硬结
ultramontane	 n. 山那边的人；教皇绝对权力主义者 adj. 山那边的
calumny	 n. 诽谤；中伤；诬蔑
seedy	 adj. 多种子的；结籽的；破烂的；没精打采的；下流的
qualm	 n. 疑虑；不安
taciturn	 adj. 沉默寡言的；无言的，不太说话的
punctual	 adj. 准时的，守时的；精确的
displacement	 n. 取代，位移；[船] 排水量
periscope	 n. 潜望镜
assess	 v. 评定；估价；对…征税
pauper	 n. 乞丐；穷人；靠救济度日者 adj. 贫民的
colloquy	 n. 以对话体写的文章；谈话，会话
bestrew	 v. 布满；散布
intrinsic	 adj. 本质的，固有的
comely	 adj. 清秀的，标致的
homologous	 adj. 相应的；[生物] 同源的；类似的；一致的
ingenuous	 adj. 天真的；坦白的；正直的；朴实的
nebula	 n. 星云；角膜云翳
prosecute	 v. 检举；贯彻；从事；依法进行
ebullient	 adj. 热情洋溢的；沸腾的
absence	 n. 没有；缺乏；缺席；不注意
coercion	 n. 强制；强迫；高压政治；威压
circumvent	 v. 包围；智取；绕行，规避
amatory	 adj. 恋爱的，情人的
swindle	 n. 欺诈；骗局 v. 诈骗；骗取
preemption	 n. 优先购买；强制收购；抢先占有；取代
athirst	 adj. 渴望的
ensemble	 n. 全体；总效果；全套服装；全套家具；合奏组 adv. 同时
artifact	 n. 人工制品；手工艺品
succumb	 v. 屈服；死；被压垮
mixture	 n. 混合；混合物；混合剂
assert	 v. 维护，坚持；断言；主张；声称
viceroy	 n. 总督；（北美）一种黑色蝴蝶
variable	 adj. 变量的；可变的；易变的，多变的；变异的，[生物] 畸变的 n. [数] 变量；可变物，可变因素
feat	 n. 功绩，壮举；技艺表演 adj. 合适的；灵巧的
decrease	 n. 减少，减小；减少量 v. 减少，减小
figurine	 n. 小雕像，小塑像
prohibition	 n. 禁止；禁令；禁酒；诉讼中止令
caucus	 n. 干部会议；核心会议；党团会议 v. 召开干部会议；开核心会议
hormone	 n. [生理] 激素，荷尔蒙
sentient	 adj. 有感情的；有感觉力的；意识到的 n. 有知觉的人
blockbuster	 n. 轰动；巨型炸弹；一鸣惊人者
questionable	 adj. 可疑的；有问题的
punctilious	 adj. 一丝不苟的；精密细心的；拘泥形式的
album	 n. 相簿；唱片集；集邮簿；签名纪念册
valediction	 n. 告别演说；告别词
encounter	 v. 遭遇，邂逅；遇到 n. 遭遇，偶然碰见
ruminate	 v. 反刍；沉思；反复思考
stunt	 n. 噱头，手腕；绝技 v. 阻碍…的正常生长或发展
abrupt	 adj. 生硬的；突然的；唐突的；陡峭的
drought	 n. 干旱；缺乏
affected	 adj. 受到影响的；做作的；假装的 vt. 影响；假装；使…感动（affect的过去式和过去分词）
commit	 v. 犯罪，做错事；把交托给；指派…作战；使…承担义务
cherish	 v. 珍爱
glamorous	 adj. 迷人的，富有魅力的
pluralism	 n. 多元主义；多元论；兼任
instance	 n. 实例；情况；建议 v. 举为例
barometer	 n. [气象] 气压计；晴雨表；显示变化的事物
austere	 adj. 严峻的；简朴的；苦行的；无装饰的
disingenuous	 adj. 虚伪的；不诚实的；不老实的；狡猾的
miscount	 v. 数错；算错 n. 数错；误算
charming	 adj. 迷人的；可爱的 v. 使陶醉（charm的现在分词）
deference	 n. 顺从；尊重
preempt	 v. 先占；先取；以先买权获得
practitioner	 n. 开业者，从业者，执业医生
pageant	 n. 盛会；游行；虚饰；露天表演
pigment	 n. [物][生化] 色素；颜料 v. 给…着色
lacerate	 v. 伤害，使…痛心；割裂；撕碎 adj. 受折磨的；撕碎的
efficacious	 adj. 有效的；灵验的
conjugation	 n. 结合，配合；动词的词形变化
ambulance	 n. [车辆][医] 救护车；战时流动医院
humble	 adj. 谦逊的；简陋的；（级别或地位）低下的；不大的 v. 使谦恭；轻松打败（尤指强大的对手）；低声下气
minority	 n. 少数民族；少数派；未成年 adj. 少数的；属于少数派的
fortitude	 n. 刚毅；不屈不挠；勇气
antibody	 n. [免疫] 抗体
narrate	 v. 叙述；给…作旁白
sophism	 n. 诡辩
sum	 n. 金额；总数 v. 概括
unyielding	 adj. 不屈的；坚强的；[材] 不易弯曲的
paragon	 n. 模范；完美之物；优秀之人 adj. 完美的
aliment	 n. 滋养品；食物 v. 向…提供营养物
illiterate	 adj. 文盲的；不识字的；没受教育的 n. 文盲
panorama	 n. 全景，全貌；全景画；概论
vivify	 v. 使生动；使活跃；给与生气
abundant	 adj. 丰富的；充裕的；盛产
acrimony	 n. 辛辣；尖刻；严厉
rust	 n. 锈；生锈；[植保] 锈病 v. 使生锈；腐蚀
fission	 n. 裂变；分裂；分体；分裂生殖法
volition	 n. 意志，意志力；决断力
recapitulate	 v. 概括；重述要点；摘要
ominous	 adj. 预兆的；不吉利的
pedigree	 n. 血统；家谱 adj. 纯种的
ethnic	 adj. 种族的；人种的
negate	 v. 否定；取消；使无效 n. 对立面；反面
granular	 adj. 颗粒的；粒状的
malodorous	 adj. 有恶臭的；令人极为反感的；不合法的
nascent	 adj. 初期的；开始存在的，发生中的
negotiate	 v. 谈判，商议；转让；越过
capricious	 adj. 反复无常的；任性的
impartial	 adj. 公平的，公正的；不偏不倚的
organic	 adj. [有化] 有机的；组织的；器官的；根本的
distort	 v. 扭曲；使失真；曲解
temporal	 adj. 暂时的；当时的；现世的 n. 世间万物；暂存的事物
scribble	 n. 潦草写成的东西；潦草的写法；杂文 v. 乱写；滥写；潦草地书写
calculus	 n. [病理] 结石；微积分学
electrolysis	 n. [化学] 电解，[化学] 电解作用；以电针除痣
circuit	 n. [电子] 电路，回路；巡回；一圈；环道 v. 环行
dissuade	 v. 劝阻，劝止
relish	 n. 滋味；风味；食欲；开胃小菜；含义；调味品 v. 盼望;期待;享受; 品味；喜爱；给…加佐料
brief	 adj. 简短的，简洁的；短暂的，草率的 n. 摘要，简报；概要，诉书 v. 简报，摘要；作…的提要
impetuous	 adj. 冲动的；鲁莽的；猛烈的
odorous	 adj. 香的；有气味的；难闻的
malice	 n. 恶意；怨恨；预谋
astringent	 adj. 涩的；收敛性的；止血的；严厉的 n. [药] 收敛剂；止血药
brine	 n. 卤水；盐水；海水 v. 用浓盐水处理（或浸泡）
venerable	 adj. 庄严的，值得尊敬的；珍贵的
prototype	 n. 原型；标准，模范
corrupt	 adj. 腐败的，贪污的；堕落的 v. 使腐烂；使堕落，使恶化
agility	 n. 敏捷；灵活；机敏
coercive	 adj. 强制的；胁迫的；高压的
carnage	 n. 大屠杀；残杀；大量绝灭
simultaneously	 adv. 同时地
urea	 n. [肥料] 尿素
serenity	 n. 平静，宁静；晴朗，风和日丽
toxic	 adj. 有毒的；中毒的
yearling	 n. 一岁家畜；满一岁的动物 adj. 一岁的
guile	 n. 狡猾；诡计；欺诈
affiliation	 n. 友好关系；加入；联盟；从属关系
compression	 n. 压缩，浓缩；压榨，压迫
cameo	 n. （影视剧中的）配角；刻有浮雕的宝石或贝壳；小品文
sacrosanct	 adj. 神圣不可侵犯的；极神圣的
nugatory	 adj. 无价值的；琐碎的；无效的；无法律效力的
brigadier	 n. 准将；陆军准将
gregarious	 adj. 社交的；群居的
unqualified	 adj. 不合格的；无资格的；不胜任的；不受限制的；无条件的；绝对的
risible	 adj. 可笑的；爱笑的；引人笑的
criticize	 v. 批评；评论；非难
bauble	 n. 小玩意；美观而无价值的饰物
assiduous	 adj. 刻苦的，勤勉的
irksome	 adj. 令人厌烦的，讨厌的；令人厌恶的
alienable	 adj. 可让与的，可转让的
benevolence	 n. 仁慈；善行
tripod	 n. [摄] 三脚架；三脚桌
cavil	 v. 吹毛求疵；挑剔 n. 吹毛求疵；苛责；无端的指责
acumen	 n. 聪明，敏锐
episode	 n. 插曲；一段情节；插话；有趣的事件
negligent	 adj. 疏忽的；粗心大意的
monarchy	 n. 君主政体；君主国；君主政治
hydrolysis	 n. 水解作用
sphere	 n. 范围；球体 vt. 包围；放入球内；使…成球形 adj. 球体的
wane	 v. 衰落；变小；亏缺；退潮；消逝 n. 衰退；月亏；衰退期；缺损
probe	 n. 探针；调查 v. 调查；探测
figurative	 adj. 比喻的；修饰丰富的；形容多的
odoriferous	 adj. 臭的，散发气味的；芬芳的
usurp	 v. 篡夺；夺取；侵占
inconsequential	 adj. 不重要的；不合理的；不合逻辑的
chronology	 n. 年表；年代学
impalpable	 adj. 感触不到的；难理解的；无形的
overweight	 adj. 超重的；过重的 vt. 使负担过重 n. 超重
length	 n. 长度，长；时间的长短；（语）音长
usury	 n. 高利；高利贷；利益
pejorative	 adj. 轻蔑的；[临床] 恶化的，变坏的 n. 轻蔑语
prolific	 adj. 多产的；丰富的
obsequious	 adj. 谄媚的；奉承的；顺从的
concede	 v. 承认；退让；给予，容许
edge	 n. 边缘；优势；刀刃；锋利 v. 使锐利；将…开刃；给…加上边
profuse	 adj. 丰富的；很多的；慷慨的；浪费的
toxin	 n. 毒素；毒质
nuisance	 n. 讨厌的人；损害；麻烦事；讨厌的东西
denominator	 n. [数] 分母；命名者；共同特征或共同性质；平均水平或标准
abjure	 v. 发誓放弃；公开放弃；避免
sanguineous	 adj. 血的；血红色的；多血质的；乐观的
access	 v. 使用；存取；接近 n. 进入；使用权；通路
zeitgeist	 n. 时代思潮，时代精神
gratuitous	 adj. 无理由的，无端的；免费的
stun	 v. 使震惊；打昏；给以深刻的印象 n. 昏迷；打昏；惊倒；令人惊叹的事物
abrasion	 n. 磨损；磨耗；擦伤
spontaneous	 adj. 自发的；自然的；无意识的
malign	 v. 诽谤，污蔑；中伤，说坏话 adj. 恶意的，恶性的；有害的
foliate	 v. 把…打成箔；加叶饰 adj. 有叶的；叶状的；成薄片的
ruin	 n. 废墟；毁坏；灭亡 v. 毁灭；使破产
perimeter	 n. 周长；周界；[眼科] 视野计
watt	 n. 瓦特
esoteric	 adj. 秘传的；限于圈内人的；难懂的
ponder	 v. 仔细考虑；衡量 n. (Ponder)人名；(英)庞德
subsist	 v. 存在；维持生活
surmount	 v. 克服，越过；战胜
immaculate	 adj. 完美的；洁净的；无瑕疵的
bole	 n. [林] 树干；红玄武土
stipend	 n. 奖学金；固定薪金；定期津贴；养老金
servile	 adj. 奴隶的；奴性的；卑屈的；卑屈的
compromise	 v. 妥协；危害 n. 妥协，和解；折衷
incongruous	 adj. 不协调的；不一致的；不和谐的
transformer	 n. [电] 变压器；促使变化的人
transcription	 n. 抄写；抄本；誊写
ensconce	 v. 安置；安顿下来；使…隐藏
complicate	 v. 使复杂化；使恶化；使卷入
rationalization	 n. 合理化
accuse	 v. 控告，指控；谴责；归咎于
chronometer	 n. [天] 精密记时表；高度精确的钟表；航海经线仪
implication	 n. 含义；暗示；牵连，卷入；可能的结果，影响
imperious	 adj. 专横的；迫切的；傲慢的
prescient	 adj. 预知的；有先见之明的
innate	 adj. 先天的；固有的；与生俱来的
dissent	 v. 不同意；不信奉国教 n. 异议；（大写）不信奉国教
discourteous	 adj. 失礼的，无礼貌的；粗鲁的
sleight	 n. 手法，技巧；熟练，灵巧；诡计
ostensible	 adj. 表面的；假装的
controversial	 adj. 有争议的；有争论的
indebted	 adj. 负债的；感激的；受惠的 v. 使负债；使受恩惠（indebt的过去分词）
obtrude	 v. 逼使；强迫；冲出
ambassador	 n. 大使；代表；使节
wiry	 adj. 金属线制的；金属丝般的；坚硬的；瘦长结实的；（噪音）尖细的
wave	 v. 波动；起伏；挥手示意；摇动；呈波形 n. 波动；波浪；高潮；挥手示意；卷曲
summon	 v. 召唤；召集；鼓起；振作
penurious	 adj. 吝啬的；缺乏的；贫困的
knead	 v. 揉合，揉捏；按摩；捏制
justifiable	 adj. 可辩解的，有道理的；可证明为正当的
concordant	 adj. 和谐的；协调的；一致的；和声的
dismantle	 v. 拆除；取消；解散；除掉…的覆盖物
orchestra	 n. 管弦乐队；乐队演奏处
alcove	 n. 凹室；壁龛
outweigh	 v. 比…重（在重量上）；比…重要；比…有价值
bond	 n. 债券；结合；约定；粘合剂；纽带 v. 结合，团结在一起
votive	 adj. 奉献的（副词votively）；献纳的；诚心祈求的
sanguine	 adj. 乐观的；满怀希望的；面色红润的 vt. 血染；以血沾污 n. 血红色
verisimilitude	 n. 逼真，貌似真实；逼真的事物
wary	 adj. 谨慎的；机警的；惟恐的；考虑周到的
vector	 n. 矢量；带菌者；航线 vt. 用无线电导航
triple	 adj. 三倍的；三方的 n. 三倍数；三个一组 v. 增至三倍
mean	 adj. 平均的；卑鄙的；低劣的；吝啬的 v. 意味；想要；意欲 n. 平均值
percolate	 v. 过滤；渗出；浸透 n. 滤过液；渗出液
perturb	 v. 扰乱；使…混乱；使…心绪不宁
longevity	 n. 长寿，长命；寿命
coalition	 n. 联合；结合，合并
ephemeral	 adj. 短暂的；朝生暮死的 n. 只生存一天的事物
immoral	 adj. 不道德的；邪恶的；淫荡的
impassioned	 adj. 充满激情的；感激的 v. 使充满激情（impassion的过去式和过去分词）
consecrate	 v. 奉献；使神圣；供神用；献身于 adj. 神圣的；被献给神的
avow	 v. 承认；公开宣称；坦率承认
familiarity	 n. 熟悉，精通；亲密；随便
matter	 n. 物质；事件 v. 有关系；要紧
lunatic	 adj. 疯狂的；精神错乱的；愚蠢的 n. 疯子；疯人
gesture	 n. 姿态；手势 v. 作手势；用动作示意
precipitate	 n. [化学] 沉淀物 v. 使沉淀；促成；猛抛；使陷入 adj. 突如其来的；猛地落下的；急促的
jerky	 adj. 抽筋的；急动的；不平稳的 n. 牛肉干
prodigy	 n. 奇迹，奇事；奇才；奇观；预兆
casualty	 n. 意外事故；伤亡人员；急诊室
domestic	 adj. 国内的；家庭的；驯养的；一心只管家务的 n. 国货；佣人
assent	 v. 同意；赞成 n. 同意；赞成
beleaguer	 v. 围攻；围
assassin	 n. 刺客，暗杀者
vista	 n. 远景，狭长的街景；展望；回顾
accouter	 v. 装备；供以军用品，供以服装
premier	 adj. 第一的；最初的 n. 总理，首相
humbug	 n. 骗子；欺骗；谎话 v. 欺骗；哄骗
seethe	 v. 沸腾；冒泡；激动 n. 沸腾；感情等的迸发
substantive	 adj. 有实质的；大量的；真实的；独立存在的 n. 名词性实词；独立存在的实体
boon	 n. 恩惠；福利；利益 adj. 愉快的；慷慨的
rejuvenate	 v. 使年轻；使更新；使恢复精神；使复原
indolence	 n. 懒散，懒惰；无痛
literal	 adj. 文字的；逐字的；无夸张的
dormant	 adj. 休眠的；静止的；睡眠状态的；隐匿的 n. (Dormant)人名；(法)多尔芒
anthropologist	 n. 人类学家；人类学者
alliance	 n. 联盟，联合；联姻
malleable	 adj. 可锻的；可塑的；有延展性的；易适应的
falsify	 v. 伪造；篡改；歪曲；证明虚假
visibility	 n. 能见度，可见性；能见距离；明显性
inordinate	 adj. 过度的；无节制的；紊乱的
truncated	 adj. 缩短了的；被删节的；切去顶端的 v. 缩短（truncate的过去分词）；截去…的顶端
canary	 n. [鸟] 金丝雀；淡黄色
cosmopolitan	 adj. 世界性的；世界主义的，四海一家的 n. 四海为家者；世界主义者；世界各地都有的东西
wavelet	 n. 微波，小浪
ironic	 adj. 讽刺的；反话的
verdict	 n. 结论；裁定
amour	 n. 恋情；偷情，奸情
weightlessness	 n. 失重；无重状态
systematic	 adj. 系统的；体系的；有系统的；[图情] 分类的；一贯的，惯常的
habituate	 v. 使习惯于，使熟悉于
substantial	 adj. 大量的；实质的；内容充实的 n. 本质；重要材料
harmonious	 adj. 和谐的，和睦的；协调的；悦耳的
intelligence	 n. 智力；情报工作；情报机关；理解力；才智，智慧；天分
hedonism	 n. 快乐主义；快乐论
unbecoming	 adj. 不适当的，不相称的；不合身的，不得体的
garble	 v. 断章取义；歪曲；混淆 n. 断章取义；混淆；篡改
foolhardy	 adj. 有勇无谋的；蛮干的
elasticity	 n. 弹性；弹力；灵活性
ritual	 n. 仪式；惯例；礼制 adj. 仪式的；例行的；礼节性的
nickname	 n. 绰号；昵称 v. 给……取绰号；叫错名字
patter	 n. 行话；轻快脚步声；急速拍打声 v. 滴答地响；急速地说；发出急速轻拍声
pendulum	 n. 钟摆；摇锤；摇摆不定的事态
prudish	 adj. 装正经的；过分规矩的
introductory	 adj. 引导的，介绍的；开端的
divulge	 v. 泄露；暴露
enthusiastic	 adj. 热情的；热心的；狂热的
vigilant	 adj. 警惕的；警醒的；注意的；警戒的
foil	 v. 衬托；阻止，挡开；挫败；贴箔于 n. 箔，金属薄片；衬托，烘托；叶形片 abbr. 面向文件的翻译语言（file-Oriented interpretive language）
spinous	 adj. 刺状的；多刺的；尖尖的；难弄的
lassitude	 n. 疲乏；懒散；厌倦
lexicographer	 n. 词典编纂者
fervid	 adj. 热的；热心的
myriad	 adj. 无数的；种种的 n. 无数，极大数量；无数的人或物
infirmary	 n. 医务室；医院；养老院
empathetic	 adj. 移情作用的；同感的（等于empathic）
innovate	 v. 创新；改革；革新
grievous	 adj. 痛苦的；剧烈的
dishevel	 v. 使蓬乱；使头发凌乱；弄乱
neologism	 n. 新词；新义；新词的使用
grimy	 adj. 肮脏的，污秽的
aghast	 adj. 吓呆的，惊骇的；吃惊的
persuasive	 adj. 有说服力的；劝诱的，劝说的
side	 n. 方面；侧面；旁边 v. 支持；赞助；偏袒 adj. 旁的，侧的
tumult	 n. 骚动；骚乱；吵闹；激动
nocturnal	 adj. 夜的；夜曲的；夜间发生的
merriment	 n. 欢喜；嬉戏
parse	 v. 解析；从语法上分析 n. 从语法上分析；分列
stir	 n. 搅拌；轰动 v. 搅拌；激起；惹起
entrench	 v. 确立，牢固；用壕沟围住；挖掘
wizen	 vi. 枯萎；凋谢；干瘪 vt. 使凋谢；使枯萎；使干瘪 adj. 凋谢的；枯萎的
gratify	 v. 使满足；使满意，使高兴
burning	 adj. 燃烧的；强烈的；发热的 n. 燃烧 vi. 燃烧（burn的现在分词）
conspicuous	 adj. 显著的；显而易见的
subjugate	 v. 征服；使服从；克制
rupture	 n. 破裂；决裂；疝气 v. 破裂；发疝气
joggle	 v. 啮合；摇动，摇曳；轻摇 n. 啮合；轻摇，摇动；榫接
sequence	 n. [数][计] 序列；顺序；续发事件 v. 按顺序排好
remonstrance	 n. 抗议；规劝；谏书
informal	 adj. 非正式的；不拘礼节的；随便的；通俗的；日常使用的
interact	 v. 互相影响；互相作用 n. 幕间剧；幕间休息
antedate	 v. 先于；前于 n. 比实际提前的日期
enchant	 v. 使迷惑；施魔法
precise	 adj. 精确的；明确的；严格的
arcade	 n. 拱廊；（内设投角子电子游戏机等的）游乐场；有拱廊的街道 vt. 使有拱廊
melancholy	 adj. 忧郁的；使人悲伤的 n. 忧郁；悲哀；愁思
rowdy	 adj. 吵闹的；粗暴的 n. 粗暴的人；好吵闹的人
discreet	 adj. 谨慎的；小心的
glycogen	 n. 糖原；动物淀粉
hardihood	 n. 刚毅，大胆；厚颜；胆大无敌
refute	 v. 反驳，驳斥；驳倒
component	 adj. 组成的，构成的 n. 成分；组件；[电子] 元件
astound	 v. 使惊骇；使震惊
overthrow	 n. 推翻；倾覆；瓦解 v. 推翻；打倒；倾覆
perspective	 n. 观点；远景；透视图 adj. 透视的
ocular	 adj. 眼睛的；视觉的；目击的 n. [光] 目镜
quadrilateral	 n. 四边形 adj. 四边形的
enervate	 v. 使衰弱，使失去活力 adj. 衰弱的，无力的
assonance	 n. 类似的音，谐音；类韵
eminence	 n. 显赫；卓越；高处
rebut	 v. 反驳；揭露；拒绝 n. 驳回；提出反证
spectrum	 n. 光谱；频谱；范围；余象
pedagogue	 n. 教师，教员；卖弄学问者
impend	 v. 迫近；即将发生
utter	 v. 发出，表达；发射 adj. 完全的；彻底的；无条件的 n. (Utter)人名；(德、芬)乌特
unsavory	 adj. 难吃的；没有香味的；令人讨厌的
maple	 n. 枫树；淡棕色
discern	 v. 识别；领悟，认识
alderman	 n. 市议员；总督；市府参事；高级市政官
devalue	 v. 使贬值；降低…的价值
impunity	 n. 不受惩罚；无患；[法] 免罚
paradoxical	 adj. 矛盾的；诡论的；似非而是的
overflow	 v. 溢出；泛滥；充溢 n. 充满，洋溢；泛滥；超值；溢值
crude	 adj. 粗糙的；天然的，未加工的；粗鲁的 n. 原油；天然的物质
orator	 n. 演说者；演讲者；雄辩家；原告
compulsory	 adj. 义务的；必修的；被强制的 n. （花样滑冰、竞技体操等的）规定动作
chronicle	 n. 编年史，年代记；记录 v. 记录；把…载入编年史
disparate	 adj. 不同的；不相干的；全异的 n. 无法相比的东西
degradation	 n. 退化；降格，降级；堕落
scrutinize	 v. 细阅；作详细检查 n. 仔细或彻底检查
promotion	 n. 提升，[劳经] 晋升；推销，促销；促进；发扬，振兴
legitimate	 adj. 合法的；正当的；合理的；正统的 v. 使合法；认为正当（等于legitimize）
enact	 v. 颁布；制定法律；扮演；发生
benevolent	 adj. 仁慈的；慈善的；亲切的
landscape	 n. 风景；风景画；景色；山水画；乡村风景画；地形；（文件的）横向打印格式 v. 对…做景观美化，给…做园林美化；从事庭园设计
analysis	 n. 分析；分解；验定
annuity	 n. 年金，养老金；年金保险；年金享受权
incubus	 n. 梦魇；沉重的负担
jurisprudence	 n. 法律体系；法学及其分支；法律知识；法院审判规程
timidity	 n. 胆怯，胆小；羞怯
asylum	 n. 庇护；收容所，救济院
oratory	 n. 雄辩；演讲术
ozone	 n. [化学] 臭氧；新鲜的空气
custodian	 n. 管理人；监护人；保管人
avidity	 n. 热望，贪欲；活动性
controversy	 n. 争论；论战；辩论
sequacious	 adj. 盲从的；合于逻辑的；缺乏独创性的
infection	 n. 感染；传染；影响；传染病
stubborn	 adj. 顽固的；顽强的；难处理的
primordial	 adj. 原始的；根本的；原生的
rankle	 v. 化脓；怨恨；发炎
mistrust	 v. 不信任；怀疑 n. 不信任；怀疑
palatable	 adj. 美味的，可口的；愉快的
felicitous	 adj. 恰当的；善于措辞的；幸福的
equilateral	 adj. 等边的；等面的 n. 等边形
surety	 n. 担保；保证；保证人
theoretical	 adj. 理论的；理论上的；假设的；推理的
annotate	 v. 注释；给…作注释或评注
replete	 adj. 充满的；装满的 n. [昆] 贮蜜蚁
chaste	 adj. 纯洁的；贞洁的；有道德的；朴素的 n. (Chaste)人名；(法)沙斯特
laudatory	 adj. 赞美的；赞赏的；称赞的
tenure	 n. 任期；占有 v. 授予…终身职位
colloquialism	 n. 白话，口语；口语体；方言用语
forgo	 v. 放弃；停止；对…断念
resplendent	 adj. 光辉的；华丽的
eternal	 adj. 永恒的；不朽的
suffuse	 v. 充满；弥漫
bereave	 v. 使……失去；使……孤寂
recessive	 adj. 隐性的；逆行的；后退的 n. 隐性性状
lobby	 n. 大厅；休息室；会客室；游说议员的团体 v. 对……进行游说
clockwise	 adv. 顺时针方向地 adj. 顺时针方向的
verify	 v. 核实；查证
sequent	 adj. 连续的；其次的；作为结果而产生的 n. 结果；相继发生的事
assonate	 v. （使）音相谐，（使）成为准押韵
involve	 v. 包含；牵涉；使陷于；潜心于
nuclei	 n. 核心，核子；原子核（nucleus的复数形式）
highlight	 v. 突出；强调；使显著；加亮 n. 最精彩的部分；最重要的事情；加亮区
singe	 v. 烧焦；烤焦 n. 烧焦；烤焦
sensor	 n. 传感器
grandiloquent	 adj. 夸张的；夸大的；大言不惭的
authenticity	 n. 真实性，确实性；可靠性
reagent	 n. [试剂] 试剂；反应物
fortify	 v. 加强；增强；（酒）的酒精含量；设防于
desperate	 adj. 不顾一切的；令人绝望的；极度渴望的
mechanics	 n. 力学（用作单数）；结构；技术；机械学（用作单数）
nullify	 v. 使无效，作废；取消
ambulate	 v. 走动；步行；移动
canto	 n. 篇；曲调；长诗的篇章
isolate	 v. 使隔离；使孤立；使绝缘 n. [生物] 隔离种群 adj. 隔离的；孤立的
diagnostic	 adj. 诊断的；特征的 n. 诊断法；诊断结论
expedite	 v. 加快；促进；发出 adj. 畅通的；迅速的；方便的
potentate	 n. 统治者，君主；有权势的人
ban	 v. 禁止，取缔 n. 禁令，禁忌
transfer	 n. 转让；转移；传递；过户 v. 转让；转学；换车
teem	 v. 大量出现；充满 n. (Teem)人名；(英)蒂姆
abscond	 v. 逃匿，潜逃；避债
prodigious	 adj. 惊人的，异常的，奇妙的；巨大的
predestine	 v. 注定
addle	 v. 使腐坏；使混乱 adj. 腐坏的；糊涂的，昏乱的
siege	 n. 围攻；包围；围城；不断袭击；长期努力 vt. 围攻；包围
pointer	 n. 指针；指示器；教鞭；暗示
vegetable	 n. 蔬菜；植物；植物人 adj. 蔬菜的；植物的
compensate	 v. 补偿，赔偿；抵消
tyro	 n. 新手，生手；初学者
gargantuan	 adj. 庞大的，巨大的
vicissitude	 n. 变迁；盛衰；变化无常；变迁兴衰
anemia	 n. 贫血；贫血症
obliterate	 v. 消灭；涂去；冲刷；忘掉
tropical	 adj. 热带的；热情的；酷热的
bulbous	 adj. 球根的；球根状的；由球根生长的（等于bulbaceous）
plea	 n. 恳求，请求；辩解，辩护；借口，托辞
vegetative	 adj. 植物的；植物人状态的，无所作为的；促使植物生长的；有生长力的
gossip	 n. 小道传闻；随笔；爱说长道短的人 v. 闲聊；传播流言蜚语
subscribe	 v. 订阅；捐款；认购；赞成；签署
anhydrous	 adj. 无水的
arbitrate	 v. 仲裁；公断
butt	 n. 屁股；烟头；笑柄；靶垛；粗大的一端 v. 以头抵撞；碰撞
bibulous	 adj. 吸水的；嗜酒的
hierarchy	 n. 层级；等级制度
pea	 n. 豌豆
impede	 v. 阻碍；妨碍；阻止
exceed	 v. 超过；胜过
legible	 adj. 清晰的；易读的；易辨认的
sedate	 adj. 安静的；沉着的 v. 给…服镇静剂
exclude	 v. 排除；排斥；拒绝接纳；逐出
archbishop	 n. 大主教；总教主
scuttle	 n. 天窗；煤桶；筐 v. 逃避；急促地跑
bestial	 adj. 兽性的，卑劣的；残忍的；野蛮的 n. 牛
bucolic	 adj. 牧歌的；牧羊的；乡下风味的 n. 田园诗；农夫
exhume	 v. 发掘；掘出 n. (Exhume)人名；(法)埃克叙姆
conceivable	 adj. 可能的；想得到的，可想像的
reasoning	 n. 推理；论证；评理 adj. 推理的 v. 推论；说服（reason的ing形式）
acquittal	 n. 赦免；无罪开释；履行；尽职；（债务等的）清偿
enthusiast	 n. 狂热者，热心家
sulfur	 v. 用硫磺处理 n. 硫磺；硫磺色
mellifluous	 adj. 流畅的；如蜜般的
force	 n. 力量；武力；军队；魄力 v. 促使，推动；强迫；强加
petrify	 v. 石化；惊呆
linguistics	 n. 语言学
neology	 n. 新词；旧词新义（等于neologism）
onus	 n. 责任，义务；负担
misdeed	 n. 罪行；犯罪
ecosystem	 n. 生态系统
disinfect	 v. 将…消毒
glimmer	 n. 微光；闪光；少许 v. 闪烁；发微光
vegetation	 n. 植被；植物，草木；呆板单调的生活
remainder	 n. [数] 余数，残余；剩余物；其余的人 adj. 剩余的；吃剩的 v. 廉价出售；削价出售
affluent	 adj. 富裕的；丰富的；流畅的 n. 支流；富人
exact	 adj. 准确的，精密的；精确的 v. 要求；强求；急需
disseminate	 v. 宣传，传播；散布
fusion	 n. 融合；熔化；熔接；融合物；[物] 核聚变
rearrange	 v. 重新排列；重新整理
fastidious	 adj. 挑剔的；苛求的，难取悦的；（微生物等）需要复杂营养地
subvert	 v. 颠覆；推翻；破坏
piteous	 adj. 可怜的；哀怨的；慈悲的
gloaming	 n. 黄昏；夕幕 v. 日落；天变黑（gloam的现在分词）
detach	 v. 分离；派遣；使超然
accredit	 v. 授权；信任；委派；归因于
addendum	 n. 附录，附件；补遗；附加物
miser	 n. 守财奴；吝啬鬼；（石油工程上用的）凿井机
ashen	 adj. 灰色的；苍白的
unruly	 adj. 不守规矩的；任性的；难驾驭的
profligate	 adj. 放荡的，不检点的；恣意挥霍的 n. 放荡者；享乐者
notorious	 adj. 声名狼藉的，臭名昭著的
fertilization	 n. [农] 施肥；[胚] 受精；肥沃
larvae	 n. 幼虫；幼体（larva的复数形式）
animosity	 n. 憎恶，仇恨，敌意
profiteer	 v. 赚大钱；牟取暴利 n. [贸易] 奸商；牟取暴利的人
coddle	 v. 娇养；溺爱（等于mollycoddle）；用文火煮
discredit	 v. 不信；使……丢脸 n. 怀疑；无信用；名声的败坏
ambush	 n. 埋伏，伏击；伏兵 v. 埋伏，伏击
ribaldry	 n. 猥亵的话；粗俗下流的言语
digest	 v. 消化；吸收；融会贯通 n. 文摘；摘要
tribute	 n. 礼物；[税收] 贡物；颂词；（尤指对死者的）致敬，悼念，吊唁礼物
braggart	 n. 吹嘘；好自夸者；大言者 adj. 吹牛的；自夸的
tolerate	 v. 忍受；默许；宽恕
path	 n. 道路；小路；轨道
macrophage	 n. [组织] 巨噬细胞
fugacious	 adj. 无常的；短暂的；易逃逸的
quantitative	 adj. 定量的；量的，数量的
pretentious	 adj. 自命不凡的；炫耀的；做作的
subordinate	 n. 下属，下级；部属，属下 adj. 从属的；次要的 v. 使……居下位；使……服从
vacuum	 n. 真空；空间；真空吸尘器 adj. 真空的；利用真空的；产生真空的 v. 用真空吸尘器清扫
promiscuous	 adj. 混杂的；杂乱的 adv. 偶然地；胡乱地
germination	 n. 发芽；发生；伟晶作用
despair	 n. 绝望；令人绝望的人或事 v. 绝望，丧失信心
avuncular	 adj. 伯父的；叔伯的；慈祥的
annual	 adj. 年度的；每年的 n. 年刊，年鉴；一年生植物
outlast	 v. 比…长久；从…中逃生
agreement	 n. 协议；同意，一致
inject	 v. 注入；注射
modify	 v. 修改，修饰；更改
finch	 n. 雀科鸣鸟；雀类
impregnable	 adj. 无法攻取的；不受影响的；要塞坚固的；不可受孕的
halve	 v. 二等分；把……减半 n. (Halve)人名；(芬)哈尔韦
illuminate	 v. 阐明，说明；照亮；使灿烂；用灯装饰
treachery	 n. 背叛；变节；背叛行为
enrage	 v. 激怒；使暴怒
spore	 n. 孢子 vi. 长孢子
competitive	 adj. 竞争的；比赛的；求胜心切的
appraise	 v. 评价，鉴定；估价
energy	 n. [物] 能量；精力；活力；精神
residential	 adj. 住宅的；与居住有关的
exterior	 adj. 外部的；表面的；外在的 n. 外部；表面；外型；外貌
glorious	 adj. 光荣的；辉煌的；极好的
parch	 v. 烤，烘；使干透
deluge	 n. 洪水；泛滥；暴雨 v. 使泛滥；压倒
temerity	 n. 鲁莽，冒失；蛮勇
meritorious	 adj. 有功绩的；有价值的；值得称赞的
vaccinate	 v. 接种疫苗 n. 被接种牛痘者
quantity	 n. 量，数量；大量；总量
nominee	 n. 被任命者；被提名的人；代名人
convergence	 n. [数] 收敛；会聚，集合
impeccable	 adj. 无瑕疵的；没有缺点的
submarine	 n. 潜水艇；海底生物 adj. 海底的；水下的 v. 用潜水艇攻击
frowzy	 adj. 不整洁的（等于frowsy）；有臭味的；霉臭的
integrate	 v. 使…完整；使…成整体；求…的积分；表示…的总和 adj. 整合的；完全的 n. 一体化；集成体
outlive	 v. 比…活得长；比…经久；经受住；渡过…而存在
cardinal	 n. 红衣主教；枢机主教；鲜红色；【鸟类】(北美)主红雀 adj. 主要的，基本的；深红色的
halcyon	 adj. 宁静的；平稳的 n. 翡翠鸟；神翠鸟
consistency	 n. [计] 一致性；稠度；相容性
feasible	 adj. 可行的；可能的；可实行的
supersede	 v. 取代，代替；紧接着……而到来
stanza	 n. 演出期；局；场；诗的一节
absurd	 adj. 荒谬的；可笑的 n. 荒诞；荒诞作品
intermediate	 v. 起媒介作用 adj. 中间的，中级的 n. [化学] 中间物；媒介
secant	 adj. 割的；切的；交叉的 n. 割线；正割
penchant	 n. 嗜好；倾向
badger	 n. 獾；獾皮；（大写）獾州人（美国威斯康星州人的别称）；<动><澳>毛鼻袋熊 v. 纠缠不休；吵着要；烦扰
becalm	 v. 使安静；使停滞；因无风而使停航
vacuous	 adj. 空的；空虚的；空洞的；无意义的
euphemism	 n. 委婉语；委婉说法
permutation	 n. [数] 排列；[数] 置换
cataract	 n. [眼科] 白内障；大瀑布；暴雨，洪水；奔流 vt. 倾注
tantrum	 n. 发脾气；发怒
pheromone	 n. 信息素（用于生化领域）；费洛蒙（昆虫分泌以刺激同种昆虫之化合物质）
extinct	 adj. 灭绝的，绝种的；熄灭的 vt. 使熄灭
precipice	 n. 悬崖；绝壁；险境
complex	 adj. 复杂的；合成的 n. 复合体；综合设施
contestant	 n. 竞争者；争辩者
intercept	 v. 拦截；截断；窃听 n. 拦截；[数] 截距；截获的情报
berate	 v. 严责；申斥
genotype	 n. 基因型；遗传型
irrelevant	 adj. 不相干的；不切题的
beneficiary	 n. [金融] 受益人，受惠者；封臣 adj. 拥有封地的；受圣俸的
influential	 adj. 有影响的；有势力的 n. 有影响力的人物
aggrieve	 v. 使悲痛；冒犯；侵害…的合法权利
proxy	 n. 代理人；委托书；代用品
electron	 n. 电子
washout	 n. 冲刷；失败者
reptile	 adj. 爬虫类的；卑鄙的 n. 爬行动物；卑鄙的人
perspire	 v. 流汗；分泌；渗出
repress	 v. 抑制；镇压（叛乱等）；约束
catalogue	 n. 目录；（美）大学情况一览 v. 把…编入目录
deter	 v. 制止，阻止；使打消念头 n. (Deter)人名；(德)德特尔
complicity	 n. 共谋；串通；共犯关系
idealist	 n. 空想家，理想主义者；唯心主义者 adj. 理想主义的；唯心主义的
anesthetic	 adj. 麻醉的；感觉缺失的 n. 麻醉剂，麻药
verdant	 adj. 青翠的；翠绿的；没有经验的；不老练的 n. (Verdant)人名；(法)韦尔当
allocate	 v. 分配；拨出；使坐落于
translucent	 adj. 透明的；半透明的
divide	 v. 划分；除；分开；使产生分歧 n. [地理] 分水岭，分水线
lurid	 adj. 可怕的，耸人听闻的；火烧似的；苍白的；血红的；华丽而庸俗的
optimism	 n. 乐观；乐观主义
reckless	 adj. 鲁莽的，不顾后果的；粗心大意的 n. (Reckless)人名；(英)雷克利斯
mercurial	 adj. 水银的；水星的；墨丘利神的；雄辩机智的；活泼善变的 n. 汞剂；水银剂
relapse	 v. 故态复萌；旧病复发；再度堕落；再陷邪道 n. 复发，再发；故态复萌；回复原状
apothecary	 n. 药剂师；药师；药材商
rampant	 adj. 猖獗的；蔓延的；狂暴的；奔放的 n. (Rampant)人名；(法)朗庞
scholastic	 adj. 学校的；学者的；学术的（等于scholastical） n. 学者；学生；墨守成规者；经院哲学家
saponaceous	 adj. 圆滑的；肥皂似的；口齿伶俐的
assonant	 adj. 类韵的；谐音的
arbitrary	 adj. [数] 任意的；武断的；专制的
proportion	 n. 比例，占比；部分；面积；均衡 v. 使成比例；使均衡；分摊
crass	 adj. 愚钝的；粗鲁的；非常的 n. (Crass)人名；(英)克拉斯
botanical	 adj. 植物学的 n. 植物性药材
urine	 n. 尿
grief	 n. 悲痛；忧伤；不幸
annihilation	 n. 灭绝；消灭
audible	 adj. 听得见的
bigamist	 n. 重婚者
metal	 n. 金属；合金 v. 以金属覆盖 adj. 金属制的
humane	 adj. 仁慈的，人道的；高尚的
catholicity	 n. 普遍性；宽容
acoustic	 adj. 声学的；音响的；听觉的 n. 原声乐器；不用电传音的乐器
engender	 v. 使产生；造成
idealize	 v. 理想化；形成思想
disorient	 v. 使…迷惑；使…失去方向感
evoke	 v. 引起，唤起；博得
mainstream	 n. 主流
belief	 n. 相信，信赖；信仰；教义
discontinue	 v. 停止；使中止
nucleon	 n. [高能] 核子
sensitivity	 n. 敏感；敏感性；过敏
dignify	 v. 使高贵；增威严；授以荣誉
dividend	 n. 红利；股息；[数] 被除数；奖金
prolong	 v. 延长；拖延
diplomatic	 adj. 外交的；外交上的；老练的
refugee	 n. 难民，避难者；流亡者，逃亡者
resourceful	 adj. 资源丰富的；足智多谋的；机智的
economic	 adj. 经济的，经济上的；经济学的
electrode	 n. 顽皮雷弹
difference	 n. 差异；不同；争执
nauseous	 adj. 令人作呕的；厌恶的
protract	 v. 绘制；延长；伸展
inebriate	 v. 灌醉；使陶醉；使兴奋 adj. 酒醉的；醉醺醺的；陶醉的 n. 酒鬼；醉汉
myopia	 n. [眼科] 近视；目光短浅，缺乏远见
dour	 adj. 严厉的；顽强的；阴沉的；不爱讲话的 n. (Dour)人名；(法)杜尔
innovative	 adj. 革新的，创新的；新颖的；有创新精神的
penumbra	 n. 半影
canon	 n. 标准；教规；正典圣经；教士
volt	 n. 伏特（电压单位）；环骑；闪避
tangible	 adj. 有形的；切实的；可触摸的 n. 有形资产
stability	 n. 稳定性；坚定，恒心
autopsy	 n. 验尸；[病理][特医] 尸体解剖；[病理][特医] 尸体剖检
foreordain	 v. 注定；预定命运
corpse	 n. 尸体
midpoint	 n. 中点；正中央
quandary	 n. 困惑；窘境；为难
transmit	 v. 传输；传播；发射；传达；遗传
emit	 v. 发出，放射；发行；发表
atonement	 n. 赎罪；补偿，弥补
altar	 n. 祭坛；圣坛；圣餐台
hoary	 adj. 久远的，古老的；灰白的
isothermal	 adj. 等温的；等温线的 n. 等温线
corpulent	 adj. 肥胖的
interrupt	 v. 中断；打断；插嘴；妨碍 n. 中断
immediate	 adj. 立即的；直接的；最接近的
complication	 n. 并发症；复杂；复杂化；混乱
grandeur	 n. 壮丽；庄严；宏伟
altruist	 n. 爱他主义者；利他主义者
genetic	 adj. 遗传的；基因的；起源的
canny	 adj. 精明的，谨慎的；节约的 n. (Canny)人名；(英)坎尼
economical	 adj. 经济的；节约的；合算的
wean	 v. 使断奶；使断念；使放弃 n. （苏格兰）幼儿
latest	 adv. 最迟地；最后地 n. 最新的事物 adj. 最新的，最近的；最迟的，最后的
altruism	 n. 利他；利他主义
munificence	 n. 慷慨给与；宽宏大量
curve	 n. 曲线；弯曲；曲线球；曲线图表 v. 弯；使弯曲 adj. 弯曲的；曲线形的
antagonism	 n. 对抗，敌对；对立；敌意
convoluted	 adj. 复杂的；费解的；旋绕的 v. 盘绕；缠绕（convolute的过去分词）
polyglot	 n. 通晓数种语言的人；用通晓数种语言记载的书 adj. 通数国语言，数国语言的
antagonist	 n. 敌手；[解剖] 对抗肌；[生化] 拮抗物；反协同试剂
opaque	 adj. 不透明的；不传热的；迟钝的 n. 不透明物 vt. 使不透明；使不反光
initiate	 v. 开始，创始；发起；使初步了解 n. 开始；新加入者，接受初步知识者 adj. 新加入的；接受初步知识的
inexplicable	 adj. 费解的；无法说明的；不能解释的
glucose	 n. 葡萄糖；葡糖（等于dextrose）
perilous	 adj. 危险的，冒险的
soporific	 n. 催眠剂；安眠药 adj. 催眠的；想睡的
ingredient	 n. 原料；要素；组成部分 adj. 构成组成部分的
pithy	 adj. 有髓的，多髓的；精练的；简洁有力的
frugal	 adj. 节俭的；朴素的；花钱少的
abbey	 n. 大修道院，大寺院；修道院中全体修士或修女
refract	 v. 使折射
disclose	 v. 公开；揭露
comestibles	 n. 食物 adj. 可吃的，可食的
undersell	 v. 抛售；以低于市价售出
arrear	 n. 欠款，逾期债款；待完成的工作
sumptuous	 adj. 华丽的，豪华的；奢侈的
mendacious	 adj. 虚假的；说谎的
gaiety	 n. 快乐，兴高采烈；庆祝活动，喜庆；（服饰）华丽，艳丽
bisect	 v. 平分；二等分
alcohol	 n. 酒精，乙醇
syndrome	 n. [临床] 综合症状；并发症状；校验子；并发位
mediator	 n. 调停者；传递者；中介物
radius	 n. 半径，半径范围；[解剖] 桡骨；辐射光线；有效航程
invective	 adj. 谩骂的；恶言的 n. 恶言漫骂
tonic	 n. 补药；主调音或基音 adj. 滋补的；声调的；使精神振作的
loquacious	 adj. 饶舌的，多话的
legacy	 n. 遗赠，遗产
intrepid	 adj. 无畏的；勇敢的；勇猛的
egoism	 n. 利己主义，自我主义
trestle	 n. [交] 栈桥，高架桥；支架，搁凳
switch	 v. 转换；用鞭子等抽打 n. 开关；转换；鞭子
probation	 n. 试用；缓刑；查验
bulwark	 n. 壁垒；保障；防波堤 v. 保护；筑垒保卫
fluctuate	 v. 波动；涨落；动摇
slothful	 adj. 怠惰的，懒惰的；迟钝的
rectitude	 n. 公正；诚实；清廉
gyrate	 v. 旋转 adj. 旋涡状的
zephyr	 n. 和风；西风；轻薄织物
furbish	 v. 磨光；恢复；更新
artery	 n. 动脉；干道；主流
equivocate	 v. 说模棱两可的话；支吾， 躲闪；推诿；含糊其词
irreverent	 adj. 不敬的，无礼的
pedagogy	 n. 教育；教育学；教授法
prelude	 n. 前奏；序幕；前奏曲 v. 成为…的序幕；演奏…作为前奏曲
tedious	 adj. 沉闷的；冗长乏味的
tarnish	 n. 晦暗，无光泽；污点 v. 玷污；使……失去光泽；使……变灰暗
kernel	 n. 核心，要点；[计] 内核；仁；麦粒，谷粒；精髓
factual	 adj. 事实的；真实的
venial	 adj. 可原谅的；（罪过）轻微的；可宽恕的
interrogate	 v. 审问；质问；[计] 询问
endemic	 adj. 地方性的；风土的 n. 地方病
degree	 n. 程度，等级；度；学位；阶层
verity	 n. 真实；真理；事实；真实性
sonorous	 adj. 响亮的；作响的；能发出响亮声音的
crystallization	 n. 结晶化；具体化
bug	 n. 臭虫，小虫；故障；窃听器 v. 烦扰，打扰；装窃听器
ratiocination	 n. 推理；推论
monocracy	 n. 独裁政治
reversible	 adj. 可逆的；可撤消的；可反转的 n. 双面布料
beget	 v. 产生；招致；引起；当…的父亲
swift	 n. 褐雨燕 adj. 快的；迅速的；敏捷的；立刻的 adv. 迅速地
inflammable	 adj. 易燃的；易怒的；易激动的 n. 易燃物
hydrate	 n. 水合物；氢氧化物 v. 使成水化合物
demur	 v. 反对；抗辩；提出异议 n. 异议；反对
aroma	 n. 芳香
incommodious	 adj. 不便的；狭窄的
latent	 adj. 潜在的；潜伏的；隐藏的
submission	 n. 投降；提交（物）；服从；（向法官提出的）意见；谦恭
disguise	 v. 掩饰；假装；隐瞒 n. 伪装；假装；用作伪装的东西
geology	 n. 地质学；地质情况
reproduce	 v. 复制；再生；生殖；使…在脑海中重现
stratum	 n. （组织的）层；[地质] 地层；社会阶层
regenerate	 v. 使再生；革新 adj. 再生的；革新的
engrave	 v. 雕刻；铭记
epistolary	 adj. 书信的；书信体的；用书信的
enterprise	 n. 企业；事业；进取心；事业心
mollify	 v. 平息，缓和；使…平静；使…变软
facetious	 adj. 诙谐的；爱开玩笑的；滑稽的；(尤指在不合适的时候)开玩笑的
nutrition	 n. 营养，营养学；营养品
cognitive	 adj. 认知的，认识的
auspice	 n. 赞助，主办；吉兆
outstretch	 vt. 拉长；伸展得超出的范围
pitch	 v. 倾斜；投掷；搭帐篷；坠落 n. 沥青；音高；程度；树脂；倾斜；投掷；球场
encumber	 v. 阻塞；妨害；拖累
exposure	 n. 暴露；曝光；揭露；陈列
litmus	 n. [试剂] 石蕊
audacity	 n. 大胆；厚颜无耻
imbue	 v. 灌输；使感染；使渗透
armful	 n. 一抱之量；双手合抱量
eject	 v. 喷射；驱逐，逐出
hilarious	 adj. 欢闹的；非常滑稽的；喜不自禁的
complement	 n. 补语；余角；补足物 v. 补足，补助
recurrent	 adj. 复发的；周期性的，经常发生的
immortal	 adj. 不朽的；神仙的；长生的 n. 神仙；不朽人物
comprehend	 v. 理解；包含；由…组成
predetermine	 v. 预先确定；预先决定；预先查明
cramp	 n. 痉挛，绞痛；[五金] 铁夹钳 v. 束缚，限制；使…抽筋；以铁箍扣紧 adj. 狭窄的；难解的；受限制的
harbinger	 n. 先驱；前兆；预告者 v. 预告；充做…的前驱
boycott	 v. 联合抵制；拒绝参加 n. 联合抵制
aphorism	 n. 格言；警句
rampart	 n. 壁垒；垒；防御土墙 vt. 用壁垒围绕；防卫
afoot	 adj. 在进行中的；徒步的；准备中 adv. 在进行中，在准备中
bacterium	 n. [微] 细菌；杆菌属
potential	 n. 潜能；可能性；[电] 电势 adj. 潜在的；可能的；势的
eschew	 v. 避免；避开；远避
dogmatic	 adj. 教条的；武断的
bombardier	 n. 投弹手；炮兵下士
inheritance	 n. 继承；遗传；遗产
pillage	 v. 掠夺；抢劫 n. 掠夺；掠夺物
blunder	 v. 跌跌撞撞地走；犯大错 n. 大错
uproarious	 adj. 骚动的；喧嚣的
centiliter	 n. [计量] 厘升，公勺
antagonize	 v. 使…敌对；使…对抗；对…起反作用
homogeneity	 n. 同质；同种；同次性（等于homogeneousness）
belittle	 v. 轻视；贬低；使相形见小
magnanimous	 adj. 宽宏大量的；有雅量的；宽大的
abyss	 n. 深渊；深邃，无底洞，地狱
belated	 adj. 迟来的；误期的
kidney	 n. [解剖] 肾脏；腰子；个性
fledgling	 n. 无经验的人；刚会飞的幼鸟
monk	 n. 僧侣，修道士；和尚
indomitable	 adj. 不屈不挠的；不服输的；不气馁的
solemn	 adj. 庄严的，严肃的；隆重的，郑重的
arrogant	 adj. 自大的，傲慢的
upheaval	 n. 剧变；隆起；举起
personality	 n. 个性；品格；名人
rescind	 v. 解除；废除；撤回
allude	 v. 暗指，转弯抹角地说到；略为提及，顺便提到
sapiential	 adj. 智慧的；明智的；赋予智慧的
mutilate	 v. 切断，毁坏；使…残缺不全；使…支离破碎
ravage	 v. 毁坏；破坏；掠夺 n. 蹂躏，破坏
prophetic	 adj. 预言的，预示的；先知的
instant	 adj. 立即的；紧急的；紧迫的 n. 瞬间；立即；片刻
charlatan	 n. 吹牛者；江湖医生 adj. 骗人的
wreak	 v. 发泄；报仇；造成（巨大的破坏或伤害）
portfolio	 n. 公文包；文件夹；证券投资组合；部长职务
cathartic	 adj. 导泻的；通便的 n. [药] 泻药；[药] 通便药
wretch	 n. 可怜的人，不幸的人；卑鄙的人
image	 n. 影像；想象；肖像；偶像 v. 想象；反映；象征；作…的像
residual	 n. 剩余；残渣 adj. 剩余的；残留的
eloquence	 n. 口才；雄辩；雄辩术；修辞
causal	 adj. 因果关系的；有原因的 n. 表示原因的连词
transmission	 n. 传动装置，[机] 变速器；传递；传送；播送
pragmatic	 adj. 实际的；实用主义的；国事的
indecipherable	 adj. 无法解释的；破译不出的；难辨认的
explicit	 adj. 明确的；清楚的；直率的；详述的
valor	 n. 英勇；勇猛（等于valour）
vermicide	 n. 杀蠕虫药；打虫药
citadel	 n. 城堡；大本营；避难处
adjutant	 n. 副官，助手 adj. 辅助的
cadent	 adj. 有节奏的；降落的
resolute	 adj. 坚决的；果断的
hemoglobin	 n. [生化] 血红蛋白（等于haemoglobin）；血红素
beck	 n. 招手；点头；（英）小河
fatalism	 n. 宿命论
immense	 adj. 巨大的，广大的；无边无际的；非常好的
blithe	 adj. 愉快的；快乐无忧的
florid	 adj. 绚丽的；气色好的
satisfy	 v. 令人满意；令人满足
superior	 adj. 上级的；优秀的，出众的；高傲的 n. 上级，长官；优胜者，高手；长者
treatise	 n. 论述；论文；专著
exclusive	 adj. 独有的；排外的；专一的 n. 独家新闻；独家经营的项目；排外者
excellent	 adj. 卓越的；极好的；杰出的
extensive	 adj. 广泛的；大量的；广阔的
loot	 n. 战利品；抢劫；掠夺品 v. 抢劫，洗劫；强夺
repute	 n. 名誉；声望 v. 名誉；认为；把…称为
battery	 n. [电] 电池，蓄电池
loop	 v. 打环；翻筋斗 n. 环；圈；弯曲部分；翻筋斗
domain	 n. 领域；域名；产业；地产
carrion	 adj. 腐肉的；腐朽的 n. 腐肉；臭尸；不洁之物
biennial	 adj. 两年一次的 n. [植] 二年生植物
postwar	 adj. 战后的 n. 战后时期 adv. 战后；在战后
intruder	 n. 侵入者；干扰者；妨碍者
populace	 n. 大众；平民；人口
monologue	 n. 独白
needy	 adj. 贫困的；贫穷的；生活艰苦的 n. (Needy)人名；(英)尼迪
sheer	 adj. 绝对的；透明的；峻峭的；纯粹的 adv. 完全；陡峭地 v. 偏航 n. 偏航；透明薄织物
intensive	 adj. 加强的；集中的；透彻的；加强语气的 n. 加强器
linear	 adj. 线的，线型的；直线的，线状的；长度的
beau	 n. 花花公子；喜修饰者；情郎 adj. 美的；好的
inhospitable	 adj. 荒凉的；冷淡的，不好客的；不适居留的
suggestive	 adj. 暗示的；提示的；影射的
affix	 v. 粘上；署名；将罪责加之于 n. [语] 词缀；附加物
exceptional	 adj. 异常的，例外的 n. 超常的学生
opportune	 adj. 适当的；恰好的；合时宜的
molt	 v. 脱毛；换毛 n. 换毛；脱皮；换毛期
independent	 adj. 独立的；单独的；无党派的；不受约束的 n. 独立自主者；无党派者
succor	 n. 救援；援助者 v. 救援；援助
earthworm	 n. [无脊椎] 蚯蚓
rightful	 adj. 合法的；正当的；公正的；正直的
murderous	 adj. 杀人的，残忍的；凶残的；蓄意谋杀的
beam	 n. 横梁；光线；电波；船宽；[计量] 秤杆 v. 发送；以梁支撑；用…照射；流露
pervert	 v. 使堕落；滥用；使反常 n. 堕落者；行为反常者；性欲反常者；变态
docile	 adj. 温顺的，驯服的；容易教的
waive	 v. 放弃；搁置
deficient	 adj. 不足的；有缺陷的；不充分的
almanac	 n. 年鉴；历书；年历
autocratic	 adj. 专制的；独裁的，专横的
chilly	 adj. 寒冷的；怕冷的 n. (Chilly)人名；(法)希伊
accusatory	 adj. 非难的，指责的；控诉的，控告的
fungible	 adj. 代替的；可取代的 n. 代替物
propriety	 n. 适当；礼节；得体
endurance	 n. 忍耐力；忍耐；持久；耐久
abominate	 v. 痛恨；憎恶
caitiff	 adj. 卑劣的；胆小的 n. 卑鄙的人；胆小鬼
turgid	 adj. 肿胀的；浮夸的；浮肿的
twinge	 n. 阵痛；悔恨 v. 使刺痛；使感到剧痛
liberal	 adj. 自由主义的；慷慨的；不拘泥的；宽大的 n. 自由主义者
comical	 adj. 滑稽的，好笑的
dignity	 n. 尊严；高贵
buoyant	 adj. 轻快的；有浮力的；上涨的
compressible	 adj. 可压缩的；可压榨的
ailment	 n. 小病；不安
asinine	 adj. 驴的；愚蠢的，固执的；驴子似的
kleptomaniac	 n. 有窃盗癖的人
stellar	 adj. 星的；星球的；主要的；一流的
abbess	 n. 女修道院院长；女庵主持
befriend	 v. 帮助；待人如友；扶助
sinuous	 adj. 蜿蜒的；弯曲的；迂回的
lens	 n. 透镜，镜头；眼睛中的水晶体；晶状体；隐形眼镜；汽车的灯玻璃 vt. 给……摄影
sanction	 n. 制裁，处罚；认可；支持 v. 制裁，处罚；批准；鼓励
interim	 adj. 临时的，暂时的；中间的；间歇的 n. 过渡时期，中间时期；暂定
cadaverous	 adj. 尸体样的；惨白的
contemporary	 n. 同时代的人；同时期的东西 adj. 当代的；同时代的；属于同一时期的
gestate	 v. 使怀孕
arrogate	 v. 冒称；霸占；没来由地将…归属于
promulgate	 v. 公布；传播；发表
phase	 n. 月相
enforce	 v. 实施，执行；强迫，强制
redress	 v. 救济；赔偿；纠正；重新调整 n. 救济；赔偿；矫正
depress	 v. 压抑；使沮丧；使萧条
gall	 n. 胆汁；五倍子；怨恨；苦味 v. 烦恼；屈辱；磨伤
poise	 n. 平衡；姿势；镇静 v. 使平衡；保持姿势
ornate	 adj. 华丽的；装饰的；（文体）绚丽的
angelic	 adj. 天使的；似天使的；天国的
sensation	 n. 感觉；轰动；感动
nettle	 v. 刺激；惹恼；用荨麻刺 n. 荨麻 adj. 荨麻科的
disparity	 n. 不同；不一致；不等
frequency	 n. 频率；频繁
copious	 adj. 丰富的；很多的；多产的
milestone	 n. 里程碑，划时代的事件
fidelity	 n. 保真度；忠诚；精确；尽责
apex	 n. 顶点；尖端
clemency	 n. 仁慈；温和；宽厚
quaint	 adj. 古雅的；奇怪的；离奇有趣的；做得很精巧的
baton	 n. 指挥棒；接力棒；警棍；司令棒
termination	 n. 结束，终止
speed	 v. 超速，加速；加速，迅速前行；兴隆 n. 速度，速率；迅速，快速；昌盛，繁荣
presentient	 adj. 有预感的
instill	 v. 徐徐滴入；逐渐灌输
indicant	 adj. 指示的；表示的 n. 指示物
approximation	 n. [数] 近似法；接近；[数] 近似值
privilege	 n. 特权；优待 v. 给与…特权；特免
inculpable	 adj. 无辜的；无可非议的
accompany	 v. 陪伴，伴随；伴奏
repulsion	 n. 排斥；反驳；反感；厌恶
amend	 v. 修改；改善，改进 n. (Amend)人名；(德、英)阿门德
asperity	 n. （表面的）粗糙；（气候等的）严酷；艰苦的条件；（性格）粗暴
recondite	 adj. 深奥的；隐藏的；默默无闻的
abusive	 adj. 辱骂的；滥用的；虐待的
temperate	 adj. 温和的；适度的；有节制的
inscrutable	 adj. 神秘的；不可理解的；不能预测的；不可思议的
probity	 n. 廉洁；正直
herbivorous	 adj. [动] 食草的
onset	 n. 开始，着手；发作；攻击，进攻
ignition	 n. 点火，点燃；着火，燃烧；点火开关，点火装置
sustainable	 adj. 可以忍受的；足可支撑的；养得起的；可持续的
ultimate	 adj. 最终的；极限的；根本的 n. 终极；根本；基本原则
ardent	 adj. 热情的；热心的；激烈的；燃烧般的 n. (Ardent)人名；(法)阿尔当
camouflage	 n. 伪装，掩饰 v. 伪装，掩饰
inclusive	 adj. 包括的，包含的
adherence	 n. 坚持；依附；忠诚
argumentation	 n. 论证；争论；辩论
rouse	 v. 唤醒；激起，使振奋；惊起 n. 觉醒；奋起
realm	 n. 领域，范围；王国
verbose	 adj. 冗长的；啰嗦的
feast	 v. 享受；款待，宴请 n. 筵席，宴会；节日
palatial	 adj. 宫殿似的；宏伟的；壮丽的
congest	 v. 使充血；充塞
hospitable	 adj. 热情友好的；（环境）舒适的
regime	 n. 政权，政体；社会制度；管理体制
perforate	 v. 穿孔于，打孔穿透；在…上打齿孔
abominable	 adj. 讨厌的；令人憎恶的；糟透的
vilify	 v. 诽谤；中伤；轻视；贬低
commitment	 n. 承诺，保证；委托；承担义务；献身
disillusion	 v. 使醒悟；使不再抱幻想 n. 幻灭；醒悟
endorse	 v. 背书；认可；签署；赞同；在背面签名
neophyte	 n. 新信徒；新入教者；初学者
transgress	 v. 违反；侵犯；犯罪
inertia	 n. [力] 惯性；惰性，迟钝；不活动
rapacious	 adj. 贪婪的；掠夺的
oppressive	 adj. 压迫的；沉重的；压制性的；难以忍受的
approbation	 n. 认可；赞许；批准
reputable	 adj. 声誉好的；受尊敬的；卓越的
rampage	 n. 暴怒；暴跳；乱闹 v. 狂暴；乱闹；发怒
generosity	 n. 慷慨，大方；宽宏大量
accumulate	 v. 累积；积聚
listless	 adj. 倦怠的；无精打采的；百无聊赖的
exterminate	 v. 消灭；根除
probate	 v. [法] 遗嘱认证；处以缓刑；加以监护；在遗嘱认证法庭证明…精神失常 n. 遗嘱检验；经认证的遗嘱；遗嘱认证法院管辖范围内的一切事项 adj. [法] 遗嘱认证的
sediment	 n. 沉积；沉淀物
emancipation	 n. 解放；释放
necessity	 n. 需要；必然性；必需品
strait	 adj. 狭窄的；苦恼的 n. 海峡；困境
surround	 v. 围绕；包围 n. 围绕物 adj. 环绕立体声的
utmost	 n. 极限；最大可能 adj. 极度的；最远的
gluttonous	 adj. 贪吃的，暴食的；饕餮的
parallelogram	 n. 平行四边形
wrangle	 n. 争论；吵嘴 v. 争论；争吵
gambol	 v. 雀跃；耍闹 n. 雀跃；嬉戏
vegetarian	 n. 素食者；食草动物 adj. 素食的
hypocritical	 adj. 虚伪的；伪善的
outrageous	 adj. 粗暴的；可恶的；令人吃惊的
crepuscular	 adj. 黄昏的；朦胧的；拂晓的
vague	 adj. 模糊的；含糊的；不明确的；暧昧的 n. (Vague)人名；(法)瓦格；(英)韦格
catastrophe	 n. 大灾难；大祸；惨败
portent	 n. 前兆；预示；迹象；异常之物
malignant	 adj. [医] 恶性的；有害的；有恶意的 n. 保王党员；怀恶意的人
piecemeal	 adv. 零碎地；逐个地 adj. 零碎的；逐渐的 n. 片；块 vt. 粉碎
product	 n. 产品；结果；[数] 乘积；作品
idle	 adj. 闲置的；懒惰的；停顿的 v. 无所事事；虚度；空转
plane	 n. 飞机；平面；程度，水平 v. 刨；乘飞机旅行；翱翔 adj. 平的；平面的
hoard	 v. 积聚钱财；贮藏货物 n. 贮藏物
auspicious	 adj. 吉兆的，吉利的；幸运的
archive	 n. 档案馆；档案文件 v. 把…存档
evanescent	 adj. 容易消散的；逐渐消失的；会凋零的
reveal	 v. 显示；透露；揭露；泄露 n. 揭露；暴露；门侧，窗侧
auburn	 n. 赤褐色 adj. 赤褐色的，赭色的
mingle	 v. 混合；交往 n. (Mingle)人名；(加纳、英)明格尔
technology	 n. 技术；工艺；术语
insipid	 adj. 清淡的；无趣的
palette	 n. 调色板；颜料
seditious	 adj. 煽动性的；扰乱治安的；参与煽动的
hypnotic	 adj. 催眠的，催眠术的；易于催眠的 n. 安眠药；催眠状态的人
temper	 n. 脾气；（钢等）回火；性情；倾向 v. 使回火；锻炼；调和；使缓和
versatile	 adj. 多才多艺的；通用的，万能的；多面手的
pontiff	 n. 主教，教皇；罗马教宗
instigate	 v. 唆使；煽动；教唆；怂恿
eclectic	 adj. 折衷的；选择的；折衷学派的 n. 折衷派的人；折衷主义者
underscore	 v. 强调；划线于…下 n. 底线，[计] 下划线
enmity	 n. 敌意；憎恨
pristine	 adj. 原始的，古时的；纯朴的
trait	 n. 特性，特点；品质；少许
salamander	 n. 火蜥蜴；蝾螈目动物；耐火的人；烤箱
herbaceous	 adj. 草本的；绿色的；叶状的
reiterate	 v. 重申；反复地做
deplete	 v. 耗尽，用尽；使衰竭，使空虚
stature	 n. 身高，身材；（精神、道德等的）高度
abbreviate	 v. 缩写，使省略；使简短
glance	 n. 一瞥；一滑；闪光 v. 扫视，匆匆一看；反光；瞥闪，瞥见
expulsion	 n. 驱逐；开除
loophole	 n. 漏洞；枪眼；换气孔；射弹孔
understate	 v. 少说，少报；保守地说；有意轻描淡写
remonstrate	 v. 责备，告诫；抗议；表示异议
discrepant	 adj. 有差异的；相差的；矛盾的
endure	 v. 忍耐；容忍
hostility	 n. 敌意；战争行动
amply	 adv. 充足地；广大地 n. (Amply)人名；(俄)安普利
euphonious	 adj. 悦耳的
levy	 n. 征收；征兵，征税 v. 征收（税等）；征集（兵等）
fluctuation	 n. 起伏，波动
precarious	 adj. 危险的；不确定的
superstitious	 adj. 迷信的；由迷信引起的
acrid	 adj. 辛辣的；苦的；刻薄的
alteration	 n. 修改，改变；变更
ado	 n. 忙乱，纷扰，麻烦
catastrophic	 adj. 灾难的；悲惨的；灾难性的，毁灭性的
ethics	 n. 伦理学；伦理观；道德标准
theory	 n. 理论；原理；学说；推测
insight	 n. 洞察力；洞悉
dome	 n. 圆屋顶 vi. 成圆顶状 vt. 加圆屋顶于…上
add	 v. 加；增加；加起来；做加法 n. 加法，加法运算
gibe	 v. 嘲笑；愚弄 n. 嘲讽话
microscope	 n. 显微镜
isochronous	 adj. [物] 等时的；等步的
interchangeable	 adj. 可互换的；可交换的；可交替的
butane	 n. [有化] 丁烷
nausea	 n. 恶心，晕船；极端的憎恶
ample	 adj. 丰富的；足够的；宽敞的 n. (Ample)人名；(西)安普尔
semblance	 n. 外貌；假装；类似
radiate	 v. 辐射；传播；流露；发射；广播 adj. 辐射状的，有射线的
frustrate	 v. 挫败；阻挠；使感到灰心 adj. 挫败的；无益的
celebrate	 v. 庆祝；举行；赞美；祝贺；宣告
statute	 n. [法] 法规；法令；条例
transcribe	 v. 转录；抄写
effectual	 adj. 奏效的；会应验的；有法律效力的
deft	 adj. 灵巧的；机敏的；敏捷熟练的
potent	 adj. 有效的；强有力的，有权势的；有说服力的
buffoonery	 n. 滑稽；打诨
resource	 n. 资源，财力；办法；智谋
destructive	 adj. 破坏的；毁灭性的；有害的，消极的
yip	 n. 叫喊声 v. 犬吠；尖叫
circumspect	 adj. 细心的，周到的；慎重的
insulate	 v. 隔离，使孤立；使绝缘，使隔热
salvageable	 adj. 可抢救的；可打捞的；可挽回的；能利用的
congenital	 adj. 先天的，天生的；天赋的
nimble	 adj. 敏捷的；聪明的；敏感的
painstaking	 adj. 艰苦的；勤勉的；小心的 n. 辛苦；勤勉
intonation	 n. 声调，语调；语音的抑扬
monition	 n. 忠告；法庭传票；宗教法庭的诫谕
place	 n. 地方；住所；座位 v. 放置；任命；寄予
castigate	 v. 严惩；苛评；矫正；修订
composed	 adj. 镇静的；沉着的 v. 组成；作曲（compose的过去分词）；著作
jocund	 adj. 快活的；高兴的
untimely	 adj. 不合时宜的；过早的 adv. 不合时宜地；过早地
respite	 n. 缓解；暂缓；暂时的休息；缓期执行 v. 使缓解；使暂缓；使延期；缓期执行
tantalize	 v. 逗弄；使干着急
homeostasis	 n. [生理] 体内平衡；[自] 内稳态
acquaint	 v. 使熟悉；使认识
tortuous	 adj. 扭曲的，弯曲的；啰嗦的
hadron	 n. [高能] 强子（参与强相互作用的基本粒子）
bristle	 n. 猪鬃；刚毛 v. 发怒；竖起
abhorrent	 adj. 可恶的；厌恶的；格格不入的
appease	 v. 使平息；使满足；使和缓；对…让步
digression	 n. 离题；脱轨
indulgent	 adj. 放纵的；宽容的；任性的
ownership	 n. 所有权；物主身份
descendent	 adj. 派生的；降落的；世袭的 n. 后裔；派生物
disparage	 v. 蔑视；毁谤
minuscule	 n. 小写字；草写小字 adj. 极小的；用草写小字写的
fallible	 adj. 易犯错误的；不可靠的
hypercritical	 adj. 吹毛求疵的，苛评的
zealous	 adj. 热心的，热情的，积极的 n. (Zealous)人名；(英)泽勒斯
prescription	 n. 药方；指示；惯例 adj. 凭处方方可购买的
apprehensible	 adj. 可理解的，可了解的
irritate	 v. 刺激，使兴奋；激怒
havoc	 n. 大破坏；浩劫；蹂躏 vt. 严重破坏 vi. 损毁
centipede	 n. [无脊椎][中医] 蜈蚣
percipient	 adj. 目光敏锐的；有洞察力的 n. 有感知力的人
shrivel	 v. 枯萎；皱缩
consummate	 adj. 至上的；完美的；圆满的 v. 完成；作成；使达到极点
transgression	 n. [地质] 海侵；犯罪；违反；逸出
descry	 v. 看见；发现；察看
demagoguery	 n. 散布谣言；煽动行为；群众煽动
irrevocable	 adj. 不可改变的；不能取消的；不能挽回的
noxious	 adj. 有害的；有毒的；败坏道德的；讨厌的
denote	 v. 表示，指示
induct	 v. 引导；感应；使…就职；征召入伍
discourse	 n. 论述；谈话；演讲 v. 演说；谈论；讲述
bipartisan	 adj. 两党连立的；代表两党的
procrastinate	 v. 耽搁，延迟
facilitate	 v. 促进；帮助；使容易
transcend	 v. 胜过，超越
vocal	 adj. 歌唱的；声音的，有声的 n. 声乐作品；元音
epidermis	 n. 上皮，表皮
induce	 v. 诱导；引起；引诱；感应
pare	 v. 消减；削皮；剪；修掉（边等） n. (Pare)人名；(英)佩尔；(法)帕尔
deleterious	 adj. 有毒的，有害的
ambiguous	 adj. 模糊不清的；引起歧义的
reasonable	 adj. 合理的，公道的；通情达理的
field	 n. 领域；牧场；旷野；战场；运动场 v. 担任场外队员 adj. 扫描场；田赛的；野生的
concoct	 v. 捏造；混合而制；调合；图谋
slick	 adj. 光滑的；华而不实的；聪明的；熟练的；老套的 n. [机] 平滑器；[机] 修光工具；通俗杂志 adv. 灵活地；聪明地 v. 使光滑；使漂亮
sensibility	 n. 情感；敏感性；感觉；识别力
despicable	 adj. 卑劣的；可鄙的
braggadocio	 n. 自夸，吹牛；吹牛大王
string	 n. 线，弦，细绳；一串，一行
plumb	 v. 使垂直；探测，探索 n. 垂直；铅锤 adv. 恰恰，正；垂直地 adj. 垂直的
moribund	 adj. 垂死的；停滞不前的 n. 垂死的人
incumbent	 adj. 现任的；依靠的；负有职责的 n. 在职者；现任者；领圣俸者
cancer	 n. 癌症；恶性肿瘤
lewd	 adj. 淫荡的；猥亵的；下流的
ogle	 v. 向…抛媚眼；注视 n. 眉目传情；媚眼
aye	 n. 赞成票；投赞成票者 adv. 赞成
octagon	 n. 八边形，八角形
round	 n. 圆；循环；一回合；圆形物 adj. 圆的；完全的；大概的；肥胖的 adv. 在周围；迂回地；朝反方向；挨个 v. 完成；围捕；绕行；弄圆 prep. 附近；绕过；大约；在…周围
askance	 adv. 怀疑地；斜视地
outright	 adv. 全部地；立刻地；率直地；一直向前；痛快地 adj. 完全的，彻底的；直率的；总共的
dissonant	 adj. 刺耳的；不谐和的；不调和的
inspection	 n. 视察，检查
eligible	 adj. 合格的，合适的；符合条件的；有资格当选的 n. 合格者；适任者；有资格者
finite	 adj. 有限的；限定的 n. 有限之物
amount	 v. 总计，合计；相当于；共计；产生…结果 n. 数量；总额，总数
urchin	 n. 顽童，淘气鬼；海胆；刺猬
conservative	 adj. 保守的 n. 保守派，守旧者
exasperate	 v. 恶化；使恼怒；激怒
spasmodic	 adj. 痉挛的，痉挛性的；间歇性的
antecedent	 n. 前情；先行词；祖先 adj. 先行的；前驱的；先前的
submit	 v. 使服从；主张；呈递
cajolery	 n. 甜言蜜语；诱骗；谄媚
villainous	 adj. 罪恶的；恶棍的；恶毒的；坏透的
impression	 n. 印象；效果，影响；压痕，印记；感想；曝光（衡量广告被显示的次数。打开一个带有该广告的网页，则该广告的impression 次数增加一次）
fatuous	 adj. 愚笨的；昏庸的；发呆的；自满的
putrid	 adj. 腐败的；腐烂的；令人厌恶的
overt	 adj. 明显的；公然的；蓄意的
input	 n. 投入；输入电路 v. [自][电子] 输入；将…输入电脑
noisome	 adj. 恶臭的；有害的
choral	 adj. 合唱的；合唱队的 n. 赞美诗；唱诗班
dispensation	 n. 分配；免除；豁免；天命
vindictive	 adj. 怀恨的；有报仇心的；惩罚的
extricate	 v. 使解脱；解救；使游离
adept	 adj. 熟练的；擅长…的 n. 内行；能手
acknowledge	 v. 承认；答谢；报偿；告知已收到
gamble	 v. 赌博；孤注一掷；投机；打赌 n. 赌博；冒险；打赌
archaic	 adj. 古代的；陈旧的；古体的；古色古香的
repeal	 v. 废除；撤销；废止；放弃；否定 n. 废除；撤销
deprecate	 v. 反对；抨击；轻视；声明不赞成
accost	 v. 勾引；引诱；对…说话；搭讪
cantankerous	 adj. 脾气坏的；爱吵架的；难相处的
expend	 v. 花费；消耗；用光；耗尽
reprobate	 v. 非难；拒绝；斥责 adj. 邪恶的；堕落的 n. 恶棍，无赖
didactic	 adj. 说教的；教诲的
aversion	 n. 厌恶；讨厌的人
shun	 v. 避开，避免；回避 n. (Shun)人名；(日)春(姓)
melee	 n. 混战，格斗；互殴
liberty	 n. 自由；许可；冒失
multiform	 adj. 多样的；多种形式的
sycophant	 n. 谄媚者；奉承者 adj. 奉承的；拍马的
inadvertent	 adj. 疏忽的；不注意的（副词inadvertently）；无意中做的
extravagance	 n. 奢侈，浪费；过度；放肆的言行
atheism	 n. 不信神，无神论
iridescent	 adj. 彩虹色的；闪光的
apathetic	 adj. 冷漠的；无动于衷的，缺乏兴趣的
diaphanous	 adj. 透明的；精致的；模糊的
implement	 v. 实施，执行；实现，使生效 n. 工具，器具；手段
muddle	 v. 混合；使咬字不清晰；使微醉 n. 糊涂；困惑；混浊状态
confession	 n. 忏悔，告解；供认；表白
icon	 n. 图标；偶像；肖像，画像；圣像
mitigate	 v. 使缓和，使减轻
separate	 v. 使分离；使分开；使分居 adj. 单独的；分开的；不同的；各自的； n. 分开；抽印本
cerebral	 adj. 大脑的，脑的
tepid	 adj. 微温的，温热的；不太热烈的；不热情的
pathos	 n. 悲怅；痛苦；同情；哀婉动人的词句
heartrending	 adj. 悲惨的；令人心碎的
forceps	 n. [医] 钳子；医用镊子
analogy	 n. 类比；类推；类似
plenitude	 n. 充分；丰富；大量
foggy	 adj. 有雾的；模糊的，朦胧的
dilemma	 n. 困境；进退两难；两刀论法
conservationist	 n. 自然资源保护论者
burgher	 n. 市民（现主要指某些欧洲国家中产阶级的市民或镇民）；公民
momentary	 adj. 瞬间的；短暂的；随时会发生的
sully	 v. 玷污；使丢脸 n. 污点，损伤
subterranean	 adj. 地下的；秘密的；隐蔽的 n. 地下工作者
generalize	 v. 概括；推广；使一般化
hiatus	 n. 裂缝，空隙；脱漏部分
artful	 adj. 巧妙的；狡猾的；有技巧的；欺诈的
slovenly	 adj. 懒散的；不整洁的；马虎的 adv. 邋遢地；马虎地；不整洁地
expanse	 n. 宽阔；广阔的区域；苍天；膨胀扩张
acquaintance	 n. 熟人；相识；了解；知道
forte	 n. 长处；特长 adj. 强音的；响的 adv. 响亮地
oscillate	 v. 使振荡；使振动；使动摇
apostasy	 n. 变节；脱党；背教
diagnosis	 n. 诊断
energetic	 adj. 精力充沛的；积极的；有力的
ponderous	 adj. 笨重的；沉闷的；呆板的
bibliography	 n. 参考书目；文献目录
expect	 v. 期望；指望；认为；预料
circular	 adj. 循环的；圆形的；间接的 n. 通知，传单
arc	 n. 弧（度）；弧光（全称electric arc）；弧形物；天穹 adj. 圆弧的；反三角函数的 v. 形成电弧；走弧线
aggravation	 n. 加剧；激怒；更恶化
cauterize	 v. 烧灼；腐蚀；使麻木（等于cauterise）
clarify	 v. 澄清；阐明
retard	 v. 延迟；阻止；妨碍；使减速 n. 延迟；阻止
readjust	 v. 再调整；重新适应
archipelago	 n. 群岛，列岛；多岛的海区
periodical	 adj. [数] 周期的；定期的 n. 期刊；杂志
culpable	 adj. 有罪的；该责备的；不周到的；应受处罚的
circuitous	 adj. 迂曲的；绕行的；迂回线路的
apostate	 adj. 变节的；脱党的；背教的 n. 脱党者；变节者；叛教者
projector	 n. [仪] 投影仪；放映机；探照灯；设计者
plus	 n. 正号，加号；好处；附加额 adj. 正的；附加的 prep. 加，加上
polymer	 n. [高分子] 聚合物
phonic	 adj. 有声的，浊音的；声音的，语音的；声学的
sturdy	 adj. 坚定的；强健的；健全的 n. 羊晕倒病
plagiarism	 n. 剽窃；剽窃物
monotone	 n. 单调；单音调 adj. 单调的 vt. 单调地读
cite	 v. 引用；传讯；想起；表彰
assessor	 n. 评审员；确定税款的人；顾问
skirmish	 n. 小冲突，小规模战斗；小争论 v. 进行小规模战斗；发生小争论
extinguish	 v. 熄灭；压制；偿清
decry	 v. 责难，谴责；诽谤
riddance	 n. 摆脱；驱逐；解除
aerostat	 n. 航空器；高空气球
humdrum	 adj. 单调的；无聊的 n. 单调；乏味 vi. 单调乏味地进行
alveolar	 adj. 肺泡的；齿槽的 n. 齿槽音
occlude	 v. 使闭塞；封闭；挡住
squander	 v. 浪费 n. 浪费
contact	 n. 接触，联系 v. 使接触，联系
mode	 n. 模式；方式；风格；时尚
qualitative	 adj. 定性的；质的，性质上的
equipoise	 n. 平衡；均势
typical	 adj. 典型的；特有的；象征性的
evaporate	 v. 使……蒸发；使……脱水；使……消失
outrage	 n. 愤怒，愤慨；暴行；侮辱 v. 凌辱，强奸；对…施暴行；激起愤怒
acquire	 v. 获得；取得；学到；捕获
carouse	 v. 畅饮；欢宴 n. 喧闹的酒会或宴会；一饮而尽
sequester	 v. 使隔绝；使隐退；没收，扣押
mock	 n. 英国模拟考试（mocks） v. 愚弄，嘲弄 adj. 仿制的，模拟的，虚假的，不诚实的
apiece	 adv. 每人；每个；各自地
hut	 n. 小屋；临时营房 vt. 使住在小屋中；驻扎 vi. 住在小屋中；驻扎
chastise	 v. 惩罚；严惩；责骂
profound	 adj. 深厚的；意义深远的；渊博的
insurgent	 adj. 叛乱的；起义的 n. 叛乱者；起义者
admissible	 adj. 可容许的；可采纳的；可接受的
belligerent	 adj. 交战的；好战的；交战国的 n. 交战国；参加斗殴的人或集团
ostentatious	 adj. 招摇的；卖弄的；夸耀的；铺张的；惹人注目的
ulterior	 adj. 将来的，较远的；在那边的；隐秘不明的
point	 n. 要点；得分；标点；[机] 尖端 v. 指向；弄尖；加标点于
scatter	 v. 分散，散开；散射 n. 分散；散播，撒播
outbreak	 n. （战争的）爆发；（疾病的）发作 vi. 爆发
deceitful	 adj. 欺骗的；欺诈的；谎言的；虚伪的
precipitation	 n. [化学] 沉淀，[化学] 沉淀物；降水；冰雹；坠落；鲁莽
bacteria	 n. [微] 细菌
ebullience	 n. 奔放；兴高采烈；沸腾；冒泡
protagonist	 n. 主角，主演；主要人物，领导者
cogent	 adj. 强有力的；使人信服的
propel	 v. 推进；驱使；激励；驱策
transcript	 n. 成绩单；抄本，副本；文字记录
persevere	 v. 坚持；不屈不挠；固执己见（在辩论中）
vegetal	 adj. 植物的，植物性的；生长的 n. 植物；蔬菜
bosom	 n. 胸；胸怀；中间；胸襟；内心；乳房；内部 v. 怀抱；把…藏在心中 adj. 知心的；亲密的
determination	 n. 决心；果断；测定
farcical	 adj. 滑稽的；闹剧的；引人发笑的
indiscernible	 adj. 难识别的；看不见的
omnivorous	 adj. 杂食的；什么都读的；无所不吃的
divisible	 adj. 可分的；可分割的
destitution	 n. 穷困；缺乏
supposition	 n. 假定；推测；想像；见解
armory	 n. [军] 军械库；[军] 兵工厂（等于armoury）
garnish	 v. 装饰 n. 为增加色香味而添加的配菜；装饰品
decoy	 n. 诱饵；诱骗 v. 诱骗
refusal	 n. 拒绝；优先取舍权；推却；取舍权
heterodox	 adj. 异端的；非正统的
hydraulic	 adj. 液压的；水力的；水力学的
autobiography	 n. 自传；自传文学
postdate	 v. 填迟……的日期；把……的日期填迟；继……之后 n. 事后日期；推迟日期
fugue	 n. 赋格曲；神游症 vi. 作赋格曲 vt. 把…编成赋格曲
chastity	 n. 贞洁；纯洁；简洁
perpetuate	 v. 使不朽；保持 adj. 长存的
garrulous	 adj. 唠叨的；喋喋不休的；多嘴的
bellicose	 adj. 好战的；好斗的
immoderate	 adj. 无节制的，过度的；不适中的
outstrip	 v. 超过；胜过；比…跑得快
identical	 adj. 同一的；完全相同的 n. 完全相同的事物
somber	 adj. 忧郁的；昏暗的；严峻的；阴天的
tyranny	 n. 暴政；专横；严酷；残暴的行为（需用复数）
athwart	 adv. 横跨着；相反 prep. 横跨；与相反
specific	 adj. 特殊的，特定的；明确的；详细的；[药] 具有特效的 n. 特性；细节；特效药
absolution	 n. 赦免；免罪
testimony	 n. [法] 证词，证言；证据
excess	 n. 超过，超额；过度，过量；无节制 adj. 额外的，过量的；附加的
object	 n. 目标；物体；客体；宾语 v. 提出…作为反对的理由
trite	 adj. 陈腐的；平庸的；老一套的
epicure	 n. 老饕；美食家；享乐主义者
impoverish	 v. 使贫穷；使枯竭
emollient	 n. [药] 润肤剂；软化剂 adj. 使柔软的
intuition	 n. 直觉；直觉力；直觉的知识
permeable	 adj. 能透过的；有渗透性的
reliant	 adj. 依赖的；可靠的；信赖的
osmosis	 n. [物] 渗透；[物] 渗透性；渗透作用
error	 n. 误差；错误；过失
salutatory	 adj. 致敬意的；表示欢迎的 n. 祝词；开幕词
pertinacious	 adj. 顽固的；执拗的
urgent	 adj. 紧急的；急迫的
electromagnet	 n. 电磁体，[电] 电磁铁；电磁石
denounce	 v. 谴责；告发；公然抨击；通告废除
fold	 v. 折叠；合拢；抱住；笼罩 n. 折痕；信徒；羊栏
puerile	 adj. 幼稚的；孩子气的；未成熟的；天真的
superficial	 adj. 表面的；肤浅的 ；表面文章的；外表的；（人）浅薄的
term	 n. 术语；学期；期限；条款；(代数式等的)项 v. 把…叫做
betide	 v. 预示；降临于，发生于
menace	 n. 威胁；恐吓 v. 恐吓；进行威胁
guarantee	 n. 保证；担保；保证人；保证书；抵押品 v. 保证；担保
nihilism	 n. 虚无主义；无政府主义；恐怖行为
incentive	 n. 动机；刺激 adj. 激励的；刺激的
despondent	 adj. 沮丧的；失望的
shatter	 v. 粉碎；打碎；破坏；破掉；使散开 n. 碎片；乱七八糟的状态
morass	 n. 沼泽；困境；乱糟糟的一堆
linchpin	 n. 关键（等于lynchpin）；制轮楔；轮辖
apprehensive	 adj. 忧虑的；不安的；敏悟的；知晓的
attraction	 n. 吸引，吸引力；引力；吸引人的事物
enzyme	 n. [生化] 酶
detrimental	 adj. 不利的；有害的 n. 有害的人（或物）；不受欢迎的求婚者
autonomy	 n. 自治，自治权
nonchalant	 adj. 冷淡的，漠不关心的
exacting	 adj. 严格的；苛求的；吃力的 v. 逼取；急需（exact的ing形式）
thoroughbred	 n. 受过严格训练的人；良种动物 adj. 良种的；受过严格训练的；优秀的
grimace	 v. 扮鬼脸；作怪相；作苦相 n. 鬼脸；怪相；痛苦的表情
trick	 n. 诡计；恶作剧；窍门；花招；骗局；欺诈 v. 欺骗；哄骗；装饰；打扮 adj. 特技的；欺诈的；有决窍的
right	 adj. 正确的；直接的；右方的 v. 复正；恢复平稳 n. 正确；右边；正义 adv. 正确地；恰当地；彻底地
prate	 v. 瞎扯 n. 唠叨；空谈；瞎扯
distinction	 n. 区别；差别；特性；荣誉、勋章
nexus	 n. 关系；连结，连系
actuary	 n. [保险] 保险计算员；保险精算师
forerun	 vt. 预示；预告；走在…之前
differentiate	 v. 区分，区别
amputate	 v. 截肢；切断；删除
perspicuity	 n. （语言、文章、表达等的）明晰；简明
inert	 adj. [化学] 惰性的；呆滞的；迟缓的；无效的
alacrity	 n. 敏捷；轻快；乐意
junction	 n. 连接，接合；交叉点；接合点
paradox	 n. 悖论，反论；似非而是的论点；自相矛盾的人或事
incinerate	 v. 把……烧成灰；烧弃
native	 adj. 本国的；土著的；天然的；与生俱来的；天赋的 n. 本地人；土产；当地居民
repertory	 n. 储备；仓库；全部剧目
exacerbate	 v. 使加剧；使恶化；激怒
caprice	 n. 任性，反复无常；随想曲，怪想
insignificant	 adj. 无关紧要的
enthrone	 v. 使登基；立…为王；任为主教；崇拜
domineer	 v. 跋扈；作威作福
justify	 v. 证明合法；整理版面
vivid	 adj. 生动的；鲜明的；鲜艳的
secondary	 adj. 第二的；中等的；次要的；中级的 n. 副手；代理人
fraudulent	 adj. 欺骗性的；不正的
token	 n. 表征；代币；记号 adj. 象征的；表意的；作为对某事的保证的 vt. 象征；代表
scintillate	 v. 发出火花；闪烁
trial	 n. 试验；审讯；努力；磨炼 adj. 试验的；审讯的
sophisticated	 adj. 复杂的；精致的；久经世故的；富有经验的 v. 使变得世故；使迷惑；篡改（sophisticate的过去分词形式）
ridiculous	 adj. 可笑的；荒谬的
aggress	 v. 攻击；侵略
illegible	 adj. 难辨认的；字迹模糊的
drainage	 n. 排水；排水系统；污水；排水面积
bountiful	 adj. 丰富的；慷慨的；宽大的
hazard	 v. 赌运气；冒…的危险，使遭受危险 n. 危险，冒险；冒险的事
solar	 adj. 太阳的；日光的；利用太阳光的；与太阳相关的 n. 日光浴室
distill	 v. 提取；蒸馏；使滴下
ciliate	 n. 纤毛虫 adj. 有纤毛的
senile	 adj. 高龄的；老衰的；高龄所致的
ornamental	 adj. 装饰的，装饰性的 n. 观赏植物；装饰品
expiate	 v. 赎罪；补偿
aquatic	 adj. 水生的；水栖的；在水中或水面进行的 n. 水上运动；水生植物或动物
feign	 v. 假装；装作；捏造；想象
predict	 v. 预报，预言；预知
irrational	 adj. 不合理的；无理性的；荒谬的 n. [数] 无理数
cipher	 n. 密码；暗号；零 v. 使用密码；计算；做算术
succinct	 adj. 简洁的；简明的；紧身的
abstain	 v. 自制；放弃；避免
garner	 v. 获得；储存；把…储入谷仓 n. 谷仓
inalienable	 adj. 不可分割的；不可剥夺的；不能让与的
appalling	 adj. 可怕的；令人震惊的 v. 使惊愕；惊吓（appal的ing形式）
perspicacious	 adj. 有洞察力的；聪颖的；敏锐的
reluctant	 adj. 不情愿的；勉强的；顽抗的
root	 n. 根；根源；词根；祖先 v. 生根；根除
resistant	 adj. 抵抗的，反抗的；顽固的 n. 抵抗者
incognito	 adj. 改名的；微行的；隐姓埋名的 adv. 隐姓埋名地 n. 匿名者；微行者
lead	 n. 领导；铅；导线；榜样 v. 领导；致使；引导；指挥 adj. 带头的；最重要的
comestible	 n. 食物 adj. 可吃的，可食的
precedent	 n. 先例；前例 adj. 在前的；在先的
chicanery	 n. 狡辩；欺骗；强词夺理
ambidextrous	 adj. 双手灵巧的；怀有二心的
superfluous	 adj. 多余的；不必要的；奢侈的
malevolent	 adj. 恶毒的；有恶意的；坏心肠的
height	 n. 高地；高度；身高；顶点
personnel	 n. 人事部门；全体人员 adj. 人员的；有关人事的
inundate	 v. 淹没；泛滥；浸水；（洪水般的）扑来
burnish	 v. 擦亮；使…光亮；将…打磨光亮 n. 光泽；抛光；闪闪发光
condescending	 adj. 表现出优越感的；居高临下的 v. 屈尊（condescend的ing形式）
fumigate	 v. 熏制；香薰；用烟熏消毒
heretical	 adj. 异端的；异教的
cataclysm	 n. 灾难；大洪水，地震；（社会政治的）大变动
aggravate	 v. 加重；使恶化；激怒
execute	 v. 实行；执行；处死
guileless	 adj. 诚实的
fat	 adj. 肥的，胖的；油腻的；丰满的 n. 脂肪，肥肉 v. 养肥；在…中加入脂肪
notable	 adj. 值得注意的，显著的；著名的 n. 名人，显要人物
hemolysis	 n. [生理][免疫] 溶血（现象）；血细胞溶解
regiment	 v. 把…编成团；严格地管制 n. 团；大量
fanfare	 n. 吹牛，炫耀；喇叭或号角嘹亮的吹奏声 vt. 热热闹闹地宣布
sluggish	 adj. 萧条的；迟钝的；行动迟缓的；懒惰的 n. 市况呆滞；市势疲弱
inequity	 n. 不公平，不公正
rural	 adj. 农村的，乡下的；田园的，有乡村风味的
fascinate	 v. 使着迷，使神魂颠倒
confrontation	 n. 对抗；面对；对质
proximity	 n. 接近，[数]邻近；接近；接近度，距离；亲近
flagella	 n. 鞭毛；鞭节（flagellum的复数）
complacence	 n. 满足，自满；沾沾自喜
agrarian	 adj. 土地的；耕地的；有关土地的
raze	 v. 夷为平地；破坏；消除；拆毁 n. (Raze)人名；(法)拉兹
sordid	 adj. 肮脏的；卑鄙的；利欲熏心的；色彩暗淡的
heterogeneous	 adj. [化学] 多相的；异种的；[化学] 不均匀的；由不同成分形成的
actuate	 v. 开动（机器等）；促使，驱使；激励（人等）
cumulative	 adj. 累积的
tutelage	 n. 监护；指导
breech	 n. 臀部；后膛 vt. 给…穿上裤子；给…装上炮尾
hallowed	 adj. 神圣的，神圣化的
therapeutic	 adj. 治疗的；治疗学的；有益于健康的 n. 治疗剂；治疗学家
occasion	 n. 时机，机会；场合；理由 v. 引起，惹起
abidance	 n. 持续；遵守；居住
hydrocarbon	 n. [有化] 碳氢化合物
lavish	 adj. 浪费的；丰富的；大方的 v. 浪费；慷慨给予；滥用
effete	 adj. 衰老的；疲惫的；（土地）贫瘠的；（动植物）不育的
pathogen	 n. 病原体；病菌
voluminous	 adj. 大量的；多卷的，长篇的；著书多的
gradual	 adj. 逐渐的；平缓的 n. 弥撒升阶圣歌集
truism	 n. 自明之理；老生常谈；老套；众所周知；真实性
rational	 adj. 合理的；理性的 n. 有理数
locus	 n. [数] 轨迹；地点，所在地
population	 n. 人口；[生物] 种群，[生物] 群体；全体居民
circulate	 v. 传播，流传；循环；流通
noticeable	 adj. 显而易见的，显著的；值得注意的
obsolete	 adj. 废弃的；老式的 n. 废词；陈腐的人 vt. 淘汰；废弃
malaise	 n. 不舒服；心神不安
factorable	 adj. 可分解因子的
sensual	 adj. 感觉的；肉欲的；世俗的；感觉论的
syllable	 n. 音节 vt. 划分音节 vi. 按音节发音；讲话
tremendous	 adj. 极大的，巨大的；惊人的；极好的
sprightly	 adj. 活泼的；愉快的 adv. 活泼地
obnoxious	 adj. 讨厌的；可憎的；不愉快的
relinquish	 v. 放弃；放手；让渡
adroit	 adj. 敏捷的，灵巧的；熟练的
ballad	 n. 歌谣，民谣；叙事歌谣；流行抒情歌曲
reimburse	 v. 偿还；赔偿
prominent	 adj. 突出的，显著的；杰出的；卓越的
albeit	 conj. 虽然；即使
barbarian	 adj. 野蛮的；未开化的 n. 野蛮人
rigor	 n. 严厉；精确；苛刻；僵硬
inure	 v. 使…习惯；使…适应
elated	 adj. 兴高采烈的；得意洋洋的 v. 使兴奋（elate的过去式和过去分词）
prickle	 n. 刺；刺痛；植物的皮刺；针刺般的感觉 v. 针一般地刺；戳；使感到刺痛
libel	 n. 诽谤罪；诋毁；毁坏名誉的东西；控诉书 v. 中伤；控告；对…进行诽谤
diverse	 adj. 不同的；多种多样的；变化多的
onrush	 n. 猛冲；突进；袭击；急流
rant	 v. 咆哮；痛骂；大声责骂 n. 咆哮；激昂的演说
amphibious	 adj. [生物] 两栖的，水陆两用的；具有双重性的
requital	 n. 报答；偿还；报仇
feral	 adj. 野生的；凶猛的；阴郁的
miserly	 adj. 吝啬的；贪婪的
absorption	 n. 吸收；全神贯注，专心致志
slogan	 n. 标语；呐喊声
frivolity	 n. 轻浮；轻薄；轻率
mechanical	 adj. 机械的；力学的；呆板的；无意识的；手工操作的
meteorology	 n. 气象状态，气象学
accelerate	 v. 使……加快；使……增速
suspense	 n. 悬念；悬疑；焦虑；悬而不决
underexposure	 n. [摄] 曝光不足
pervious	 adj. 能被通过的；能接受的；可渗透的
epidemic	 adj. 流行的；传染性的 n. 传染病；流行病；风尚等的流行
heretofore	 adv. 直到此时，迄今为止；在这以前
nestle	 v. 舒适地坐定；偎依；半隐半现地处于
pedant	 n. 学究；书呆子；卖弄学问的人；空谈家
hoarse	 adj. 嘶哑的
tenacity	 n. 韧性；固执；不屈不挠；黏性
bonanza	 n. 富矿带；带来好运之事；幸运
inconvenient	 adj. 不便的；打扰的
catalyst	 n. [物化] 催化剂；刺激因素
invigorate	 v. 鼓舞；使精力充沛
antique	 adj. 古老的，年代久远的；过时的，古董的；古风的，古式的 n. 古董，古玩；古风，古希腊和古罗马艺术风格 v. 觅购古玩
persecution	 n. 迫害；烦扰
perpendicular	 adj. 垂直的，正交的；直立的；陡峭的 n. 垂线；垂直的位置
arbor	 n. [植] 乔木；凉亭；藤架
rapt	 adj. 全神贯注的；入迷的
faction	 n. 派别；内讧；小集团；纪实小说
vacuity	 n. 空虚；空白；思想贫乏；无聊之事
anonymous	 adj. 匿名的，无名的；无个性特征的
autocracy	 n. 独裁政治；专制政治；独裁政府；独裁统治的国家
acquisition	 n. 获得物，获得；收购
reservoir	 n. 水库；蓄水池
distance	 n. 距离；远方；疏远；间隔 v. 疏远；把…远远甩在后面
benign	 adj. 良性的；和蔼的，亲切的；吉利的 n. (Benign)人名；(俄)贝尼根
magnetism	 n. 磁性，磁力；磁学；吸引力
analogous	 adj. 类似的；[昆] 同功的；可比拟的
ineffectual	 adj. 无效的，不起作用的；徒劳无益的 n. 无用的人；无一技之长者
complaisant	 adj. 彬彬有礼的；顺从的；殷勤的
flounder	 v. 挣扎，折腾；错乱地做事或说话 n. 挣扎，辗转；比目鱼
concentration	 n. 浓度；集中；浓缩；专心；集合
formidable	 adj. 强大的；可怕的；令人敬畏的；艰难的
hackney	 n. 乘用马；出租马车；出租汽车；操贱役的人 vt. 役使；出租 adj. 供出租的
motley	 adj. 杂色的；混杂的；五颜六色的 n. 混杂；杂色衣服；小丑
ethical	 adj. 伦理的；道德的；凭处方出售的 n. 处方药
unknown	 adj. 未知的；陌生的，默默无闻的 n. 未知数；未知的事物，默默无闻的人
abhorrence	 n. 痛恨，厌恶
tenet	 n. 原则；信条；教义
supplementary	 adj. 补充的；追加的 n. 补充者；增补物
prosperity	 n. 繁荣，成功
rookie	 n. 新手
squelch	 v. 消除；镇压；压碎；使…咯吱咯吱的响 n. 噪声控制；嘎吱声；压倒对方的反驳；压碎的一堆
square	 adj. 平方的；正方形的；直角的；正直的 v. 使成方形；与…一致 n. 平方；广场；正方形 adv. 成直角地
spindle	 n. 轴；纺锤，锭子；细长的人或物 adj. 锭子的，锭子似的；细长的 vt. 装锭子于 vi. 长得细长，变细长
quotient	 n. [数] 商；系数；份额
optics	 n. [光] 光学
colossus	 n. 巨像；巨人；巨大的东西
proverb	 n. 谚语，格言；众所周知的人或事
synthetic	 adj. 综合的；合成的，人造的 n. 合成物
multiplicity	 n. 多样性；[物] 多重性
fable	 n. 寓言；无稽之谈 vi. 编寓言；虚构 vt. 煞有介事地讲述；虚构
elucidate	 v. 阐明；说明
penury	 n. 贫困；贫穷
endanger	 v. 危及；使遭到危险
pretext	 n. 借口；托辞 vt. 以…为借口
afresh	 adv. 重新；再度
reparable	 adj. 可修缮的；可补偿的；可挽回的
experiment	 v. 尝试；进行实验 n. 实验，试验；尝试
fictitious	 adj. 虚构的；假想的；编造的；假装的
elocution	 n. 朗诵法；演说法；雄辩术
proceed	 v. 开始；继续进行；发生；行进 n. 收入，获利
infamous	 adj. 声名狼藉的；无耻的；邪恶的；不名誉的
obscure	 adj. 昏暗的，朦胧的；晦涩的，不清楚的；隐蔽的；不著名的，无名的 v. 使…模糊不清，掩盖；隐藏；使难理解 n. 某种模糊的或不清楚的东西
quiescent	 adj. 静止的；不活动的；沉寂的
scanner	 n. [计] 扫描仪；扫描器；光电子扫描装置
anthropoid	 adj. 类人猿的；类人的；（猿等）似人类的 n. 类人猿
doleful	 adj. 寂寞的；悲哀的；阴沉的；忧郁的
prudential	 adj. 谨慎的；明辨的
imminent	 adj. 即将来临的；迫近的
intellect	 n. 智力，理解力；知识分子；思维逻辑领悟力；智力高的人
momentum	 n. 势头；[物] 动量；动力；冲力
peripheral	 adj. 外围的；次要的；（神经）末梢区域的 n. 外部设备
clarification	 n. 澄清，说明；净化
vicarious	 adj. 替代的；代理的；发同感的
languor	 n. 疲倦；无精打采；柔情；呆滞 vi. 变得衰弱无力
countless	 adj. 无数的；数不尽的
prodigal	 adj. 挥霍的；十分慷慨的 n. 浪子；挥霍者
overshadow	 v. 使失色；使阴暗；遮阴；夺去…的光彩
aspiration	 n. 渴望；抱负；送气；吸气；吸引术
drastic	 adj. 激烈的；猛烈的 n. 烈性泻药
skittish	 adj. （人或动物）不安的，易受惊的；难驾驭的
scale	 n. 规模；比例；鳞；刻度；天平；数值范围 v. 衡量；攀登；剥落；生水垢
infest	 v. 骚扰；寄生于；大批出没；大批滋生
calculable	 adj. 可计算的；能预测的；可靠的
monotonous	 adj. 单调的，无抑扬顿挫的；无变化的
circle	 n. 循环，周期；圆；圈子；圆形物 v. 盘旋，旋转；环行
attache	 n. 专员，公使；使馆随员；大使馆专员
rate	 n. 比率，率；速度；价格；等级 v. 认为；估价；责骂
celibacy	 n. 独身
unwieldy	 adj. 笨拙的；笨重的；不灵便的；难处理的
abrogate	 v. 废除；取消
allotment	 n. 分配；分配物；养家费；命运
syllabus	 n. 教学大纲，摘要；课程表
relevant	 adj. 相关的；切题的；中肯的；有重大关系的；有意义的，目的明确的
plasticity	 n. 塑性，可塑性；适应性；柔软性
premature	 adj. 早产的；不成熟的；比预期早的 n. 早产儿；过早发生的事物
lexicon	 n. 词典，辞典
larceny	 n. 盗窃；盗窃罪
incontrovertible	 adj. 无可争议的；无疑的；明白的
perusal	 n. 熟读；精读
temperance	 n. 戒酒；节欲；（气候等的）温和 adj. 温暖的；有节制的
morale	 n. 士气，斗志
cereal	 n. 谷类，谷物；谷类食品；谷类植物 adj. 谷类的；谷类制成的
reconciliation	 n. 和解；调和；和谐；甘愿
omen	 n. 预兆；征兆 v. 预示；有…的前兆；预告
evade	 v. 逃避；规避；逃脱
evaporation	 n. 蒸发；消失
anxious	 adj. 焦虑的；担忧的；渴望的；急切的
schedule	 v. 安排，计划；编制目录；将……列入计划表 n. 时间表；计划表；一览表
prank	 n. 恶作剧，开玩笑；戏谑 v. 装饰；打扮
perceptible	 adj. 可察觉的；可感知的；看得见的
caricature	 n. 漫画；讽刺画；漫画手法 v. 画成漫画讽刺
lithe	 adj. 轻盈的（等于lithesome）；柔软的；易弯曲的
primer	 n. 初级读本；识字课本；原始物
inequality	 n. 不平等；不同；不平均
claimant	 n. 原告；[贸易] 索赔人；提出要求者
oxidize	 v. 使氧化；使生锈
technique	 n. 技巧，技术；手法
reparation	 n. 赔偿；修理；赔款
misunderstand	 v. 误解；误会
effusion	 n. 渗出；泻出；渗漏物
scar	 v. 伤害；给留下伤痕 n. 创伤；伤痕
affront	 v. 冒犯，有意冒犯；面对；公开侮辱 n. 轻蔑；公开侮辱
impulsive	 adj. 冲动的；受感情驱使的；任性的
indisputable	 adj. 明白的；无争论之余地的
blunt	 adj. 钝的，不锋利的；生硬的；直率的 v. 使迟钝 n. (Blunt)人名；(英)布伦特
condescend	 v. 屈尊；俯就；（对某人）表现出优越感
temperature	 n. 温度；体温；气温；发烧
beatific	 adj. 幸福的；祝福的；快乐的
mite	 n. 极小量；小虫；小孩儿；微小的东西
topography	 n. 地势；地形学；地志
liquidate	 v. 清算；偿付；消除
veritable	 adj. 真正的，名副其实的
hustle	 v. 催促；猛推；强夺 n. 推；奔忙；拥挤喧嚷
pensive	 adj. 沉思的，忧郁的；悲伤的，哀愁的
comprehensive	 adj. 综合的；广泛的；有理解力的 n. 综合学校；专业综合测验
solder	 v. 焊接 n. 焊料；接合物
renascent	 adj. 新生的，复活的；复兴的
chaos	 n. 混沌，混乱
hysterical	 adj. 歇斯底里的；异常兴奋的
aperture	 n. 孔，穴；（照相机，望远镜等的）光圈，孔径；缝隙
cyclical	 adj. 周期的，循环的
austerity	 n. 紧缩；朴素；苦行；严厉
peddle	 v. 叫卖；兜售；散播 n. (Peddle)人名；(英)佩德尔
extant	 adj. 现存的；显著的
sagacity	 n. 睿智；聪敏；有远见
accompanist	 n. 伴奏者；伴随者
befuddle	 v. 使迷惑；使昏沉
resuscitate	 v. 使复苏；使复兴
peccadillo	 n. 轻罪；小过失；小瑕疵
ascribe	 v. 归因于；归咎于
bureaucracy	 n. 官僚主义；官僚机构；官僚政治
decrepit	 adj. 衰老的；破旧的
nautical	 adj. 航海的，海上的；船员的
arduous	 adj. 努力的；费力的；险峻的
amicable	 adj. 友好的；友善的
advert	 v. 注意；谈到 n. 广告
capacitor	 n. [电] 电容器
visualize	 v. 形象，形象化；想像，设想
oration	 n. 演说；致辞；叙述法
proponent	 n. 支持者；建议者；提出认证遗嘱者
tipsy	 adj. 喝醉的；歪曲的；不稳的
overpower	 v. 压倒；克服；使无法忍受
antemeridian	 adj. 上午的
suave	 adj. 柔和的，温和的；文雅的，娴雅的
likelihood	 n. 可能性，可能
luminescent	 adj. 发冷光的，冷光的
placid	 adj. 平静的；温和的；沉着的
inexcusable	 adj. 不可原谅的；没法辩解的；不可宽恕的
chasm	 n. 峡谷；裂口；分歧；深坑
abridge	 v. 删节；缩短；节略
cringe	 v. 畏缩；奉承；阿谀 n. 畏缩；奉承
mimic	 v. 模仿，摹拟 n. 效颦者，模仿者；仿制品；小丑 adj. 模仿的，模拟的；假装的
dubious	 adj. 可疑的；暧昧的；无把握的；半信半疑的
laudation	 n. 赞美；颂词；称赞
procedure	 n. 程序，手续；步骤
idolatry	 n. 偶像崇拜；盲目崇拜；邪神崇拜
abdominal	 adj. 腹部的；有腹鳍的
overlord	 n. 霸王；大君主；最高统治者；封建领主
sentimental	 adj. 伤感的；多愁善感的；感情用事的；寓有情感的
eyepiece	 n. [光] 目镜，[光] 接目镜
species	 n. [生物] 物种；种类 adj. 物种上的
purloin	 v. 偷窃
cancellation	 n. 取消；删除
liable	 adj. 有责任的，有义务的；应受罚的；有…倾向的；易…的
repugnant	 adj. 讨厌的；矛盾的；敌对的
bewilder	 v. 使迷惑，使不知所措
visage	 n. 面貌，容貌；外表
borough	 n. 区；自治的市镇
sustenance	 n. 食物；生计；支持
candor	 n. 坦白；直率
oust	 v. 驱逐；剥夺；取代
alter	 v. 改变，更改 n. (Alter)人名；(英)奥尔特；(德、捷、葡、爱沙、立陶、拉脱、俄、西、罗、瑞典)阿尔特
muffle	 v. 蒙住；裹住；抑制；发低沉的声音 n. 低沉的声音；消声器；包裹物（如头巾，围巾等）；唇鼻部
pancreas	 n. [解剖] 胰腺
mount	 v. 增加；爬上；使骑上马；安装，架置；镶嵌，嵌入；准备上演；成立（军队等） n. 山峰；底座；乘骑用马；攀，登；运载工具；底座
accession	 n. 增加；就职；到达 v. 登记入册
chart	 n. 图表；海图；图纸；排行榜 v. 绘制…的图表；在海图上标出；详细计划；记录；记述；跟踪（进展或发展
mate	 n. 助手，大副；配偶；同事；配对物 v. 使配对；使一致；结伴
vertical	 adj. 垂直的，直立的；[解剖] 头顶的，顶点的 n. 垂直线，垂直面
thrall	 n. 奴隶；束缚 adj. 受奴役的 vt. 使成为奴隶
perform	 v. 执行；完成；演奏
dumbfound	 v. 使惊呆；使人惊愕失声
menacing	 adj. 威胁的；险恶的 v. 威胁（menace的ing形式）；恐吓
egocentric	 adj. [心理] 自我中心的；利己主义的 n. 利己主义者
voluble	 adj. 健谈的；缠绕的；易旋转的
derivative	 n. [化学] 衍生物，派生物；导数 adj. 派生的；引出的
odious	 adj. 可憎的；讨厌的
nostalgia	 n. 乡愁；怀旧之情；怀乡病
intercession	 n. 调解；说情；仲裁
archetype	 n. 原型
raconteur	 n. 健谈者；善谈者；擅长讲故事的人
veto	 n. 否决权 v. 否决；禁止
verifiable	 adj. 可证实的；能作证的；可检验的
extraction	 n. 取出；抽出；拔出；抽出物；出身
ensnare	 v. 诱捕；诱入陷阱；进入罗网
oblique	 adj. 斜的；不光明正大的 n. 倾斜物 vi. 倾斜
germane	 adj. 有密切关系的；贴切的；恰当的 n. (Germane)人名；(英)杰曼
oxidizer	 n. [助剂] 氧化剂
morbid	 adj. 病态的；由病引起的；恐怖的；病变部位的
regulate	 v. 调节，规定；控制；校准；有系统的管理
sinecure	 n. 闲职；挂名职务
advent	 n. 到来；出现；基督降临；基督降临节
valid	 adj. 有效的；有根据的；合法的；正当的
opulent	 adj. 丰富的；富裕的；大量的
shrinkage	 n. 收缩；减低
supine	 adj. 仰卧的；懒散的；掌心向上的；向后靠的
era	 n. 时代；年代；纪元
hypotenuse	 n. 直角三角形的斜边
bestride	 v. 跨骑
revive	 v. 复兴；复活；苏醒；恢复精神
overlook	 v. 忽略；俯瞰；远眺；检查；高耸于…之上 n. 忽视；眺望
sociable	 adj. 社交的；好交际的；友善的 n. 联谊会
synopsis	 n. 概要，大纲
hectic	 n. 脸红；患肺结核 adj. 兴奋的，狂热的；脸上发红；肺病的；忙碌的
compassionate	 adj. 慈悲的；富于同情心的 v. 同情；怜悯
transparent	 adj. 透明的；显然的；坦率的；易懂的
multiple	 adj. 多重的；多样的；许多的 n. 倍数；[电] 并联
querulous	 adj. 易怒的，暴躁的；爱发牢骚的，抱怨的；爱挑剔的
typify	 v. 代表；作为…的典型；具有…的特点
protocol	 n. 协议；草案；礼仪 vt. 拟定 vi. 拟定
plasma	 n. [等离子] 等离子体；血浆；[矿物] 深绿玉髓
turpitude	 n. 卑鄙；奸恶
lambaste	 v. 痛打；严责；鞭打
forecast	 v. 预报，预测；预示 n. 预测，预报；预想
infrared	 n. 红外线 adj. 红外线的
cogitate	 v. 仔细考虑；谋划
community	 n. 社区；[生态] 群落；共同体；团体
delude	 v. 欺骗；哄骗；诱惑；【罕用】迷惑；逃避；使失望
multiply	 v. 乘；使增加；使繁殖；使相乘 adv. 多样地；复合地 adj. 多层的；多样的
starch	 n. 淀粉；刻板，生硬 v. 给…上浆
aristocracy	 n. 贵族；贵族统治；上层社会；贵族政治
myth	 n. 神话；虚构的人，虚构的事
indelible	 adj. 难忘的；擦不掉的
congruent	 adj. 适合的，一致的；全等的；和谐的
refulgent	 adj. 辉煌的；灿烂的
tempestuous	 adj. 有暴风雨的；暴乱的；剧烈的
designate	 v. 指定；指派；标出；把…定名为 adj. 指定的；选定的
misstate	 v. 说错；作虚伪叙述，谎报
airy	 adj. 空气的；通风的；幻想的；轻快的；空中的 n. (Airy)人名；(英)艾里
clarity	 n. 清楚，明晰；透明
pretend	 v. 假装，伪装，佯装 adj. 假装的
endocrine	 n. 内分泌；激素；内分泌物 adj. 内分泌的；激素的
historical	 adj. 历史的；史学的；基于史实的
magnet	 n. 磁铁；[电磁] 磁体；磁石
lodge	 n. 旅馆；门房；集会处；山林小屋 v. 提出；寄存；借住；嵌入
rectangular	 adj. 矩形的；成直角的
imperceptive	 adj. 无感觉的；缺乏感知力的
laxative	 n. 泻药；[药] 缓泻药 adj. 通便的
insouciance	 n. 无忧无虑；漫不经心；满不在乎
revolution	 n. 革命；旋转；运行；循环
leaven	 v. 使发酵；影响 n. 酵母；酵素；潜移默化的影响
jovial	 adj. 天性快活的；主神朱庇特的
capacious	 adj. 宽敞的；广阔的；容积大的
contingent	 adj. 因情况而异的；不一定的；偶然发生的；可能的；依情况而定的；偶然的；[逻]有条件的 n. 分遣队；偶然事件；分得部分；代表团
anthology	 n. （诗、文、曲、画等的）选集
avarice	 n. 贪婪，贪财
pacify	 v. 使平静；安慰；平定
obscurity	 n. 朦胧；阴暗；晦涩；身份低微；不分明
sacrifice	 n. 牺牲；祭品；供奉 v. 牺牲；献祭；亏本出售
benison	 n. 祝福
alleviate	 v. 减轻，缓和
homonym	 n. 同音异义词；同形异义词；同形同音异义词；同名异物
exponent	 n. [数] 指数；典型；说明者，说明物 adj. 说明的
cubic	 adj. 立方体的，立方的 n. (Cubic)人名；(罗)库比克
whimsical	 adj. 古怪的；异想天开的；反复无常的
stimulation	 n. 刺激；激励，鼓舞
solid	 adj. 固体的；可靠的；立体的；结实的；一致的 n. 固体；立方体
meticulous	 adj. 一丝不苟的；小心翼翼的；拘泥小节的
covert	 n. 隐藏处；树丛；蔽覆羽翮基部的羽毛 adj. 隐蔽的；隐密的；偷偷摸摸的；在丈夫保护下的
jungle	 n. 丛林，密林；危险地带 adj. 丛林的；蛮荒的
vertex	 n. 顶点；[昆] 头顶；[天] 天顶
embattle	 vt. 布阵；列阵；整军备战；严阵以待
gravitation	 n. 重力；万有引力；地心吸力
malinger	 v. 装病以逃避职责
engross	 v. 使全神贯注；用大字体书写；正式写成（决议等）；独占；吸引
shield	 n. 盾；防护物；保护者 v. 遮蔽；包庇；避开；保卫
antidote	 n. [药] 解毒剂；解药；矫正方法
knave	 n. 无赖；流氓；（纸牌中的）杰克
propaganda	 n. 宣传；传道总会
estrange	 v. 使疏远；离间
range	 n. 范围；幅度；排；山脉 v. （在内）变动；平行，列为一行；延伸；漫游；射程达到
physics	 n. 物理学；物理现象
translation	 n. 翻译；译文；转化；调任
bedeck	 v. 装饰；修饰
emergent	 adj. 紧急的；浮现的；意外的；自然发生的
quibble	 n. 谬论；双关语；遁辞 v. 诡辩；挑剔；说模棱两可的话
vaporization	 n. 蒸发；喷雾器；蒸馏器
delegate	 v. 委派…为代表 n. 代表
commencement	 n. 开始，发端；毕业典礼
tranquil	 adj. 安静的，平静的；安宁的；稳定的
ramify	 v. 分枝，分叉；成网状
fallacious	 adj. 谬误的；骗人的；靠不住的；不合理的
casual	 adj. 随便的；非正式的；临时的；偶然的 n. 便装；临时工人；待命士兵
aggressive	 adj. 侵略性的；好斗的；有进取心的；有闯劲的
paraphrase	 n. 释义；解释；意译 v. 释义
feint	 n. 佯攻；伪装 v. 佯攻；假装 adj. 假的
readily	 adv. 容易地；乐意地；无困难地
observation	 n. 观察；监视；观察报告
assassinate	 v. 暗杀；行刺
humorous	 adj. 诙谐的，幽默的；滑稽的，可笑的
confidence	 n. 信心；信任；秘密 adj. （美）诈骗的；骗得信任的
obfuscate	 v. 使模糊；使迷乱；弄暗
uproot	 v. 根除，连根拔起；迫使某人离开出生地或定居处
solidification	 n. 凝固；团结；浓缩
peninsular	 adj. 半岛的；形成半岛的；半岛状的 n. 半岛居民
shuffle	 v. 洗牌；推诿，推卸；拖曳，慢吞吞地走；搅乱 n. 洗牌，洗纸牌；混乱，蒙混；拖着脚走
hereditary	 adj. 遗传的；世袭的；世代相传的 n. 遗传类
insolent	 adj. 无礼的；傲慢的；粗野的；无耻的
arraign	 v. 传讯，控告；责难，指责
buffoon	 n. 丑角；滑稽剧演员
equitable	 adj. 公平的，公正的；平衡法的
elevate	 v. 提升；举起；振奋情绪等；提升…的职位
procure	 v. 获得，取得；导致
celerity	 n. 快速；敏捷
mask	 n. 面具；口罩；掩饰 v. 掩饰；戴面具；化装
bacchanalia	 n. （古罗马的）酒神节；大酒宴
semiconductor	 n. [电子][物] 半导体
mass	 n. 块，团；群众，民众；大量，众多；质量 adj. 群众的，民众的；大规模的，集中的 v. 聚集起来，聚集
revile	 v. 辱骂；斥责
parody	 n. 拙劣的模仿；诙谐的改编诗文 v. 拙劣模仿
luxuriant	 adj. 繁茂的；丰富的；奢华的；肥沃的
commute	 v. （搭乘车、船等）通勤；代偿 n. 通勤（口语）
cower	 v. 退缩；抖缩；蜷缩；弯腰屈膝
annex	 v. 附加；获得；并吞 n. 附加物；附属建筑物
remunerate	 v. 酬劳；给与报酬；赔偿
maritime	 adj. 海的；海事的；沿海的；海员的
isotope	 n. 同位素
acquit	 v. 无罪释放；表现；脱卸义务和责任；清偿
frolicsome	 adj. 嬉戏的，爱闹着玩的
abstruse	 adj. 深奥的；难懂的
chromatic	 adj. 彩色的；色品的；易染色的
candid	 adj. 公正的；坦白的；率直的；偷拍的 n. (Candid)人名；(罗)坎迪德
reconnoiter	 v. 侦察，勘查
zany	 adj. 滑稽的；古怪的；愚蠢的 n. 小丑；笨人；马屁精
incite	 v. 煽动；激励；刺激
abstemious	 adj. 节约的，节省的；有节制的
pundit	 n. 专家；博学者；梵文学者
wry	 adj. 歪斜的，扭歪的；歪曲的；用反语表达幽默的；揶揄的 vt. 扭曲；扭歪 vi. 扭曲；扭歪
serene	 adj. 平静的；安详的；清澈的；晴朗的 n. 平静；晴朗 vt. 使平静
virulent	 adj. 剧毒的；恶性的；有恶意的
collegian	 n. 学院的学生；学院的一员
generic	 adj. 类的；一般的；属的；非商标的
antilogy	 n. 前后矛盾
trough	 n. 水槽，水槽；低谷期；饲料槽；低气压
issue	 n. 问题；流出；期号；发行物 v. 发行，发布；发给；放出，排出
redundant	 adj. 多余的，过剩的；被解雇的，失业的；冗长的，累赘的
obesity	 n. 肥大，肥胖
engrossing	 adj. 引人入胜的 v. 使全神贯注（engross的ing形式）
attribute	 n. 属性；特质 v. 归属；把…归于
skeleton	 n. 骨架，骨骼；纲要；骨瘦如柴的人 adj. 骨骼的；骨瘦如柴的；概略的
veil	 n. 面纱；面罩；遮蔽物；托词 v. 遮蔽；掩饰；以面纱遮掩；用帷幕分隔
inept	 adj. 笨拙的；不适当的
vein	 n. 血管；叶脉；[地质] 岩脉；纹理；翅脉；性情 v. 使成脉络；象脉络般分布于
offshoot	 n. 分支；支流；衍生物
disadvantage	 n. 缺点；不利条件；损失
credible	 adj. 可靠的，可信的
opponent	 n. 对手；反对者；敌手 adj. 对立的；敌对的
rhombus	 n. [数] 菱形；[数] 斜方形
underling	 n. 下属，部下；走卒
intelligible	 adj. 可理解的；明了的；仅能用智力了解的
plunder	 n. 抢夺；战利品；掠夺品 v. 掠夺；抢劫；侵吞
autocrat	 n. 独裁者，专制君主；独断独行的人
vivacious	 adj. 活泼的；快活的；有生气的
tacit	 adj. 缄默的；不言而喻的；心照不宣的；默许的
pictograph	 n. [语] 象形文字；古代石壁画；统计图表
tense	 adj. 紧张的；拉紧的 v. 变得紧张；使拉紧 n. 时态
prominence	 n. 突出；显著；突出物；卓越
lobster	 n. 龙虾
decimal	 adj. 小数的；十进位的 n. 小数
serendipity	 n. 意外发现珍奇事物的本领；有意外发现珍宝的运气
surpass	 v. 超越；胜过，优于；非…所能办到或理解
abridgement	 n. 节略，缩写；减少
bedlam	 n. 混乱，骚乱；精神病院，疯人院
opprobrium	 n. 耻辱，不名誉；责骂，咒骂
fundamental	 adj. 基本的，根本的 n. 基本原理；基本原则
inexorable	 adj. 无情的；不屈不挠的；不可阻挡的；无法改变的
maneuver	 n. [军] 机动；演习；策略；调遣 v. [军] 机动；演习；调遣；用计谋
specialty	 n. 专业，专长；特产；特性；招牌菜 adj. 特色的；专门的；独立的
total	 adj. 全部的；完全的；整个的 v. 总数达 n. 总数，合计
succulent	 adj. 多汁的；多水分的；多汁性的 n. 肉质植物；多汁植物
agape	 adj. 张开著；张口惊视的 adv. 目瞪口呆 n. (Agape)人名；(罗)阿加佩
abet	 v. 煽动，教唆；支持 n. (Abet)人名；(意)阿贝特；(匈)奥拜特
brazier	 n. 火盆；铜匠（等于 brasier）
brethren	 n. <旧>兄弟们，同胞；〈旧〉同党，会友
exonerate	 v. 使免罪
bullock	 n. 小公牛；阉牛
peremptory	 adj. 强制的；绝对的；断然的；专横的
plenteous	 adj. 丰富的；丰饶的
hypocrite	 n. 伪君子；伪善者
abed	 adv. 在床上 n. (Abed)人名；(法)阿贝；(阿拉伯)阿比德
bleak	 adj. 阴冷的；荒凉的，无遮蔽的；黯淡的，无希望的；冷酷的；单调的
protein	 n. 蛋白质；朊 adj. 蛋白质的
staid	 adj. 固定的；沉着的；沉静的；古板的，保守的
hypocrisy	 n. 虚伪；伪善
discharge	 v. 解雇；卸下；放出；免除 n. 排放；卸货；解雇
trifle	 n. 琐事；蛋糕；少量 v. 开玩笑；闲混；嘲弄
prism	 n. 棱镜；[晶体][数] 棱柱
circumference	 n. 圆周；周长；胸围
refurbish	 v. 刷新；再磨光
solute	 n. [化学] 溶质；[化学] 溶解物 adj. 溶解的
anticlimax	 n. 突降法；虎头蛇尾；令人扫兴的结尾
miff	 n. 微怒；小争执 v. 使……恼怒
comparable	 adj. 可比较的；比得上的
primeval	 adj. 原始的；初期的（等于primaeval）
ohm	 n. 欧姆（电阻单位）
adumbrate	 v. 预示；画…的轮廓；遮蔽
voltage	 n. [电] 电压
commiserate	 v. 同情，怜悯
ridicule	 v. 嘲笑；嘲弄；愚弄 n. 嘲笑；笑柄；愚弄
contingency	 n. 偶然性；[安全] 意外事故；可能性；[审计] 意外开支；[离散数学或逻辑学]偶然式
ungainly	 adj. 笨拙的；不雅的 adv. 笨拙地；不雅地
accusation	 n. 控告，指控；谴责
stagy	 adj. 做作的，不自然的
akin	 adj. 类似的；同类的；同族的 n. (Akin)人名；(土、瑞典、尼日利)阿金；(匈)奥金；(英)埃金
hypodermic	 n. 皮下注射；皮下注射器 adj. 皮下的
ingrate	 adj. 忘恩的；不知恩的 n. 忘恩负义的人
indubitable	 adj. 不容置疑的；明确的
subdue	 v. 征服；抑制；减轻
adamant	 adj. 固执的，坚强的；坚定不移的；坚硬无比的 n. 坚硬的东西；坚石
geometric	 adj. 几何学的；[数] 几何学图形的
division	 n. [数] 除法；部门；分配；分割；师（军队）；赛区
missile	 n. 导弹；投射物 adj. 导弹的；可投掷的；用以发射导弹的
accommodate	 v. 容纳；使适应；供应；调解
anode	 n. 阳极（电解）
placate	 v. 抚慰；怀柔；使和解
swamp	 n. 沼泽；湿地 v. 使陷于沼泽；使沉没；使陷入困境
downplay	 v. 不予重视；将轻描淡写
obese	 adj. 肥胖的，过胖的
rendezvous	 n. 约会；约会地点；集结地 v. 会合；约会
monopoly	 n. 垄断；垄断者；专卖权
wrath	 n. 愤怒；激怒
surreptitious	 adj. 秘密的；鬼鬼祟祟的；暗中的
wee	 adj. 极小的；很早的 n. 一点点
reminiscent	 adj. 怀旧的，回忆往事的；耽于回想的 n. 回忆录作者；回忆者
abdicate	 v. 退位；放弃
unify	 v. 统一；使相同，使一致
hermit	 n. （尤指宗教原因的）隐士；隐居者
provincial	 adj. 省的；地方性的；偏狭的 n. 粗野的人；乡下人；外地人
bolster	 n. 支持；长枕 v. 支持；支撑
hydrogen	 n. [化学] 氢
adulterant	 n. 掺杂物 adj. 掺杂用的
disfigure	 v. 使变丑；损毁…的外形；使大为减色
barrister	 n. 律师；（加拿大）出庭律师（等于arrister-at-law）；（英）（有资格出席高等法庭并辩护的）专门律师
vernacular	 adj. 本国的；地方的；用本地语写成的 n. 本地话，方言；动植物的俗名
fray	 n. 争论；打架；磨损处 v. 使磨损；变得令人紧张、急躁
exigent	 adj. 迫切的；紧急的；苛求的
solicitous	 adj. 热切期望的；热心的；挂念的
apotheosis	 n. 神化；崇拜，颂扬；尊奉为神
considerable	 adj. 相当大的；重要的，值得考虑的
egalitarian	 adj. 平等主义的 n. 平等主义；平等主义者
intimidate	 v. 恐吓，威胁；胁迫
plaintive	 adj. 哀伤的；悲哀的
knavery	 n. 恶行，欺诈；无赖行为
buoyancy	 n. 浮力；轻快；轻松的心情；（股票）保持高价或回升
priggish	 adj. 一本正经的；自负的；死板的
suspicion	 n. 怀疑；嫌疑；疑心；一点儿 vt. 怀疑
slight	 adj. 轻微的，少量的；脆弱的；细长的；不重要的 v. 轻视，忽略；怠慢 n. 怠慢；轻蔑
latency	 n. 潜伏；潜在因素
polygamy	 n. 一夫多妻，一妻多夫，多配偶
imprint	 n. 印记；痕迹；特征；版本说明 v. 加特征；刻上记号
frightful	 adj. 可怕的；惊人的；非常的
tribulation	 n. 苦难；磨难；忧患
medley	 n. 混合；混杂；混合物 adj. 混合的；拼凑的
annalist	 n. 编年史作者；纪年表编者
renown	 n. 声誉；名望 vt. 使有声望
abase	 v. 使…谦卑；降低…的品格；降低…的地位
abash	 v. 使困窘；使羞愧；使局促不安
keepsake	 n. 纪念品
dilute	 adj. 稀释的；淡的 v. 稀释；冲淡；削弱
impervious	 adj. 不受影响的，无动于衷的；不能渗透的
apology	 n. 道歉；谢罪；辩护；勉强的替代物
efficacy	 n. 功效，效力
predicament	 n. 窘况，困境；状态
prescience	 n. 先见；预知
compress	 v. 受压缩小
recede	 v. 后退；减弱
immigrate	 v. 移入
mawkish	 adj. 令人作呕的，令人厌恶的；自作多情的；淡而无味的
contemplation	 n. 沉思；注视；意图
imperil	 v. 危及；使陷于危险
acclimate	 v. 服水土；适应新环境
tentative	 adj. 试验性的，暂定的；踌躇的 n. 假设，试验
gel	 v. 胶化 n. [物化] 凝胶，胶体
salt	 n. 盐；风趣，刺激性 adj. 咸水的；含盐的，咸味的；盐腌的；猥亵的 v. 用盐腌；给…加盐；将盐撒在道路上使冰或雪融化
reflection	 n. 反射；沉思；映象
abate	 v. 减轻；减少；废除 n. (Abate)人名；(英、意、法、埃塞)阿巴特
accentuate	 v. 强调；重读
intangible	 adj. 无形的，触摸不到的；难以理解的
pomp	 n. 盛况；浮华；壮丽；夸耀
misanthropy	 n. 厌恶人类；厌世，愤世嫉俗
area	 n. 区域，地区；面积；范围
erroneous	 adj. 错误的；不正确的
repentant	 adj. 悔改的；后悔的
bumper	 adj. 丰盛的，丰富的 n. 缓冲器，保险杆，减震物 vt. 装满；为…祝酒 vi. 干杯
hypothesis	 n. 假设
discipline	 n. 学科；纪律；训练；惩罚 v. 训练，训导；惩戒
regularity	 n. 规则性；整齐；正规；匀称
fraction	 n. 分数；部分；小部分；稍微
restoration	 n. 恢复；复位；王政复辟；归还
desolate	 adj. 荒凉的；无人烟的 v. 使荒凉；使孤寂
still	 adv. 仍然；更；静止地 adj. 静止的，不动的；寂静的，平静的；不起泡的 n. 寂静；剧照；蒸馏室 conj. 仍然；但是；尽管如此 v. 蒸馏；使…静止；使…平静下来
vaccine	 n. 疫苗；牛痘苗 adj. 疫苗的；牛痘的
amnesia	 n. 健忘症，[内科] 记忆缺失
cantata	 n. 大合唱；（意）清唱剧；康塔塔（一种声乐套曲）
augur	 n. 预言者；占兆官；占卜师 v. 预言；是…的预兆
ceremonial	 adj. 仪式的；正式的，礼仪的 n. 仪式，礼节
fetid	 adj. 臭的；恶臭的；腐臭的
eulogize	 v. 颂扬；称赞
enigmatic	 adj. 神秘的；高深莫测的；谜一般的
reprisal	 n. 报复（行为）；报复性劫掠
mischievous	 adj. 淘气的；（人、行为等）恶作剧的；有害的
provoke	 v. 驱使；激怒；煽动；惹起
radioactive	 adj. [核] 放射性的；有辐射的
redemption	 n. 赎回；拯救；偿还；实践
repartee	 n. 机敏的应答；妙语；巧辩
optic	 adj. 光学的；视觉的；眼睛的 n. 眼睛；镜片
sacrilege	 n. 冒渎；亵渎圣物；悖理逆天的行为
emblem	 n. 象征；徽章；符号 vt. 象征；用符号表示；用纹章装饰
rotate	 v. 旋转；循环 adj. [植] 辐状的
sedulous	 adj. 聚精会神的；勤勉的；勤苦工作的
inception	 n. 起初；获得学位
subsistence	 n. 生活；生存；存在
refraction	 n. 折射；折光
sensuous	 adj. 感觉上的，依感观的；诉诸美感的
lactose	 n. [有化] 乳糖
tactician	 n. 战术家；谋士
bawdy	 adj. 猥亵的；下流的；卖淫的
operation	 n. 操作；经营；[外科] 手术；[数][计] 运算
deportment	 n. 举止；行为；态度
venous	 adj. 静脉的；有脉纹的
arbiter	 n. [法] 仲裁者；裁决人
fecund	 adj. 肥沃的；多产的；丰饶的；生殖力旺盛的
occurrence	 n. 发生；出现；事件；发现
tumultuous	 adj. 吵闹的；骚乱的；狂暴的
meander	 n. 漫步；曲流（常用复数） v. 漫步；蜿蜒缓慢流动
synthesis	 n. 综合，[化学] 合成；综合体
abduction	 n. 诱拐，绑架；诱导
effusive	 adj. 流出的；感情横溢的
aggrandize	 v. 增加；夸大；强化
shiftless	 adj. 偷懒的；无计谋的；无能的
flexible	 adj. 灵活的；柔韧的；易弯曲的
vitality	 n. 活力，生气；生命力，生动性
detest	 v. 厌恶；憎恨
discount	 n. 折扣；贴现率 v. 贴现；打折扣出售商品
destination	 n. 目的地，终点
gas	 n. 气体；[矿业] 瓦斯；汽油；毒气 v. 加油；毒（死）
tenable	 adj. （主张等）站得住脚的；可维持的
haughty	 adj. 傲慢的；自大的
annals	 n. 年报；编年史；年鉴
beseech	 v. 恳求，哀求；乞求，急切地要求得到
theorist	 n. 理论家
thwart	 v. 挫败；反对；阻碍；横过 adj. 横放的；固执的 n. 划手座；独木舟的横梁 adv. 横过 prep. 横过
tractable	 adj. 易于管教的；易驾驭的；易处理的；驯良的
pension	 n. 退休金，抚恤金；津贴；膳宿费 v. 发给养老金或抚恤金
abandon	 n. 放任；狂热 v. 遗弃；放弃
allay	 v. 减轻；使缓和；使平静
filch	 v. 窃取；偷窃
novel	 adj. 新奇的；异常的 n. 小说
gap	 n. 间隙；缺口；差距；分歧 v. 裂开
abundance	 n. 充裕，丰富
creation	 n. 创造，创作；创作物，产物
humanity	 n. 人类；人道；仁慈；人文学科
recline	 v. 靠；依赖；斜倚
moment	 n. 片刻，瞬间，时刻；重要，契机
pertinent	 adj. 相关的，相干的；中肯的；切题的
trenchant	 adj. 尖刻的；锐利的；苛刻的；锋利的（名词trenchancy，副词trenchantly） n. (Trenchant)人名；(法)特朗尚
manifest	 v. 证明，表明；显示 n. 载货单，货单；旅客名单 adj. 显然的，明显的；明白的
cadaver	 n. [医] 尸体；死尸
stagnate	 v. 停滞；淤塞；变萧条
arid	 adj. 干旱的；不毛的，[农] 荒芜的
proficiency	 n. 精通，熟练
collusion	 n. 勾结；共谋
recover	 v. 恢复；弥补；重新获得 n. 还原至预备姿势
variant	 adj. 不同的；多样的 n. 变体；转化
trove	 n. 被发现的东西；收藏的东西
oak	 n. 橡树；橡木色；橡木家具 adj. 栎树的；栎木制的
prepossess	 v. 使先具有；预先灌输情感（或思想等）；使…先怀偏见；先有好感
radical	 adj. 激进的；根本的；彻底的 n. 基础；激进分子；[物化] 原子团；[数] 根数
similar	 adj. 相似的 n. 类似物
relent	 v. 变温和，变宽厚；减弱；缓和
neutralization	 n. [化学] 中和；[化学] 中和作用；中立状态
consecutive	 adj. 连贯的；连续不断的
rotary	 adj. 旋转的，转动的；轮流的 n. 旋转式机器；[动力] 转缸式发动机
obsequies	 n. 葬礼
lingual	 adj. 语言的；舌的，舌音的 n. 舌音，舌音字
fallow	 adj. 休耕的；不活跃的 n. 休耕地；休耕 vt. 使（土地）休闲；潜伏
bigamy	 n. 重婚罪，重婚
differ	 v. 使…相异；使…不同 n. (Differ)人名；(法)迪费
persistent	 adj. 固执的，坚持的；持久稳固的
benignity	 n. 仁慈；善举
astounding	 adj. 令人震惊的；令人惊骇的
fabricate	 v. 制造；伪造；装配
backstage	 adv. 在后台；向后台
salutation	 n. 称呼；问候；招呼；寒喧
resemblance	 n. 相似；相似之处；相似物；肖像
negligence	 n. 疏忽；忽视；粗心大意
enlighten	 v. 启发，启蒙；教导，开导；照耀
rebellious	 adj. 反抗的；造反的；难控制的
integrity	 n. 完整；正直；诚实；廉正
fragile	 adj. 脆的；易碎的
chromosome	 n. [遗][细胞][染料] 染色体（形容词chromosomal，副词chromosomally）
adulterate	 adj. 通奸的；搀杂的 v. 掺假
subtle	 adj. 微妙的；精细的；敏感的；狡猾的；稀薄的
buffer	 n. [计] 缓冲区；缓冲器，[车辆] 减震器 v. 缓冲
partition	 n. 划分，分开；[数] 分割；隔墙；隔离物 v. [数] 分割；分隔；区分
mediocrity	 n. 平庸之才；平常
nondescript	 adj. 平凡的，没有特色的；难以区别的；莫可名状的 n. 不属任何类型的人；难以形容的人或物
licentious	 adj. 放肆的；放纵的
archaeologist	 n. 考古学家
birthright	 n. 与生俱来的权利；长子继承权
biology	 n. （一个地区全部的）生物；生物学
champion	 n. 冠军；拥护者；战士 v. 支持；拥护 adj. 优胜的；第一流的
objective	 adj. 客观的；目标的；宾格的 n. 目的；目标；[光] 物镜；宾格
coerce	 v. 强制，迫使
humility	 n. 谦卑，谦逊
ammonia	 n. [无化] 氨，阿摩尼亚
exhaustive	 adj. 详尽的；彻底的；消耗的
misgiving	 n. 担忧；疑虑；不安 v. 担忧；使…疑虑；害怕（misgive的ing形式）
intransigent	 adj. 不妥协的；不让步的 n. 不妥协的人
banal	 adj. 陈腐的；平庸的；老一套的 n. (Banal)人名；(法、意)巴纳尔
comparison	 n. 比较；对照；比喻；比较关系
federate	 adj. 同盟的；联邦制度下的；联合的 v. 使结成同盟；使结成联邦
statement	 n. 声明；陈述，叙述；报表，清单
unassuming	 adj. 谦逊的；不装腔作势的；不出风头的
denominate	 v. 为…命名；把…称作… adj. 有特定名称的
extemporaneous	 adj. 即席的，临时的；无准备的；不用讲稿的；善于即席讲话的
pique	 v. 刺激；伤害…自尊心；激怒 n. 生气；愠怒；呕气
agglomerate	 adj. 凝聚的；成团的，结块的 n. 团块；[岩] 集块岩；附聚物 v. 使结块；使成团
aural	 adj. 听觉的；耳的；气味的；先兆的 n. (Aural)人名；(西)奥拉尔
omniscient	 adj. 全知的；无所不知的 n. 上帝；无所不知者
captivate	 v. 迷住，迷惑
seclude	 v. 使隔离，使隔绝
plummet	 n. [测] 铅锤，坠子 v. 垂直落下；（价格、水平等）骤然下跌
accomplish	 v. 完成；实现；达到
earnest	 adj. 认真的，热心的；重要的 n. 认真；定金；诚挚
projection	 n. 投射；规划；突出；发射；推测
circumscribe	 v. 外切，外接；限制；在…周围画线
vitalize	 v. 赋予…生命；激发；使有生气
disengage	 v. 使脱离；解开；解除
symphony	 n. 交响乐；谐声，和声
primp	 v. 精心打扮；装饰
network	 n. 网络；广播网；网状物
naval	 adj. 海军的；军舰的 n. (Naval)人名；(西、德、印)纳瓦尔
ordinate	 n. [数] 纵坐标
rudimentary	 adj. 基本的；初步的；退化的；残遗的；未发展的
accessible	 adj. 易接近的；可进入的；可理解的
powerless	 adj. 无力的；[劳经] 无能力的，无权的
vegetate	 v. 过单调呆板的生活
undercharge	 v. 充电不足；索价低于常价；弹药装填不足 n. 充电不足；低的索价；填不够量的火药
preoccupy	 v. 迷住；使全神贯注
avert	 v. 避免，防止；转移
denigrate	 v. 诋毁；使变黑；玷污
perfunctory	 adj. 敷衍的；马虎的；得过且过的
sophistical	 adj. 诡辩的；强词夺理的；诡辩法的
posterior	 adj. 其次的；较后的 n. 后部；臀部
fervor	 n. 热情；热烈；热心；炽热
tundra	 n. [生态] 苔原；[地理] 冻原；冻土地带
solvent	 adj. 有偿付能力的；有溶解力的 n. 溶剂；解决方法
epitome	 n. 缩影；摘要；象征
blemish	 n. 瑕疵；污点；缺点 v. 玷污；损害；弄脏
retrospect	 n. 回顾，追溯 v. 回顾，追溯；回想
contort	 v. 扭曲；曲解
phenomenon	 n. 现象；奇迹；杰出的人才
rife	 adj. 普遍的；流行的；盛传的 n. (Rife)人名；(西)里费；(英)赖夫
classify	 v. 分类；分等
microorganism	 n. [微] 微生物；微小动植物
anticipate	 v. 预期，期望；占先，抢先；提前使用
languid	 adj. 倦怠的；呆滞的；软弱无力的
wanton	 adj. 嬉戏的；繁茂的；荒唐的；无节制的；放纵的 n. 荡妇；水性杨花的女人 v. 放肆；嬉戏；闲荡
connotation	 n. 内涵；含蓄；暗示，隐含意义；储蓄的东西（词、语等）
resistance	 n. 阻力；电阻；抵抗；反抗；抵抗力
adherent	 n. 信徒；追随者 adj. 附着的；粘着的
bereft	 adj. 丧失的；被剥夺的；失去亲人的 v. 失去…的（bereave的过去式）
flair	 n. 天资；天分；资质；鉴别力
cynical	 adj. 愤世嫉俗的；冷嘲的
instinct	 n. 本能，直觉；天性 adj. 充满着的
tolerable	 adj. 可以的；可容忍的
presumptuous	 adj. 专横的；放肆的；冒昧的
undermine	 v. 破坏，渐渐破坏；挖掘地基
pentagon	 n. 五角形
voluptuous	 adj. 撩人的；骄奢淫逸的；沉溺酒色的
palliate	 v. 减轻；掩饰；辩解
abut	 v. 邻接；毗邻；紧靠 n. (Abut)人名；(英、土)阿布特
intercede	 v. 调解，调停；求情，说项
academician	 n. 院士；大学生；学会会员；大学教师
theorize	 v. 建立理论或学说；推理
glacial	 adj. 冰的；冰冷的；冰河时代的
dielectric	 adj. 非传导性的；诱电性的 n. 电介质；绝缘体
face	 n. 脸；表面；面子；面容；外观；威信 v. 向；朝
dilettante	 n. 业余爱好者；一知半解者 adj. 浅薄的；业余艺术爱好的 vi. （在艺术、科学等方面）浅尝辄止
progression	 n. 前进；连续
outlandish	 adj. 古怪的；奇异的；异国风格的；偏僻的
scanty	 adj. 缺乏的；吝啬的；仅有的；稀疏的
monogamy	 n. 一夫一妻制；[动] 单配偶，[动] 单配性
ramble	 n. 漫步；漫游；随笔 v. 漫步于…
prohibit	 v. 阻止，禁止
desiccate	 v. 变干
defer	 v. 推迟；延期；服从 n. (Defer)人名；(法)德费
lapse	 n. (一时的) 走神，判断错误
motor	 n. 发动机，马达；汽车 adj. 汽车的；机动的 v. 乘汽车
possess	 v. 控制；使掌握；持有；迷住；拥有，具备
itinerary	 n. 旅程，路线； 旅行日程 adj. 旅程的； 巡回的，流动的
underlie	 v. 成为……的基础；位于……之下
equivocal	 adj. 模棱两可的；可疑的
belle	 n. 美女
ovum	 n. [细胞][组织] 卵；卵子；卵形装饰
projectile	 adj. 抛射的；抛掷的；供抛射用的；（触角等）能伸出的 n. 射弹；抛射体；自动推进武器
guzzle	 v. 狂饮；暴食 n. 狂饮；豪饮作乐
resent	 v. 怨恨；愤恨；厌恶
hail	 n. 冰雹；致敬；招呼；一阵 v. 致敬；招呼；向欢呼；猛发；使像下雹样落下（过去式hailed，过去分词hailed，现在分词hailing，第三人称单数hails） int. 万岁；欢迎
encore	 n. 再演唱的要求；经要求而再唱 v. 要求再演或唱 int. 再来一个
inaccessible	 adj. 难达到的；难接近的；难见到的
itinerate	 v. 巡回；巡回传教
plausible	 adj. 貌似可信的，花言巧语的；貌似真实的，貌似有理的
phosphate	 n. 磷酸盐；皮膜化成
cull	 v. 精选；采集（鲜花等）；剔除 n. 剔出来杀掉的动物；拣出的等外品
tumor	 n. 肿瘤；肿块；赘生物
factor	 n. 因素；要素；[物] 因数；代理人 v. 做代理商
telescope	 v. 压缩；使套叠 n. 望远镜；缩叠式旅行袋
paroxysm	 n. （疾病周期性）发作；突发
invalidate	 v. 使无效；使无价值
affinity	 n. 密切关系；吸引力；姻亲关系；类同
angle	 v. 钓鱼；谋取 n. 角度，角，方面
vulgar	 adj. 粗俗的；通俗的；本土的 n. 平民，百姓
requite	 v. 报答，回报；酬谢
lung	 n. 肺；呼吸器
intervene	 v. 干涉；调停；插入
preference	 n. 偏爱，倾向；优先权
saturation	 n. 饱和；色饱和度；浸透；磁化饱和
producer	 n. 制作人，制片人；生产者；发生器
reclaim	 v. 开拓；回收再利用；改造某人，使某人悔改 n. 改造，感化；再生胶
irony	 n. 讽刺；反语；具有讽刺意味的事 adj. 铁的；似铁的
unctuous	 adj. 油质的；虚情假意的；油腔滑调的
competitor	 n. 竞争者，对手
nomad	 n. 游牧民；流浪者 adj. 游牧的；流浪的
alkaloid	 n. [有化] 生物碱；植物碱基
facet	 n. 面；方面；小平面 vt. 在…上琢面
travesty	 n. 歪曲；滑稽作品；拙劣的模仿作品 v. 歪曲；滑稽地模仿
resurrection	 n. 复活；恢复；复兴
seize	 v. 抓住；夺取；理解；逮捕
surrender	 v. 使投降；放弃；交出；听任 n. 投降；放弃；交出；屈服
oblivion	 n. 遗忘；湮没；赦免
penitent	 adj. 忏悔的，悔过的 n. 悔罪者，忏悔者
marsh	 n. 沼泽；湿地 adj. 沼泽的；生长在沼泽地的
candidate	 n. 候选人，候补者；应试者
protrude	 v. 使突出，使伸出
alley	 n. 小巷；小路；小径
mendicant	 adj. 行乞的；托钵修道会的 n. 乞丐；托钵僧
transistor	 n. 晶体管（收音机）
validity	 n. [计] 有效性；正确；正确性
provident	 adj. 节俭的；有先见之明的；顾及未来的
interpolate	 v. 篡改；插入新语句
fermentation	 n. 发酵
arboretum	 n. 植物园；（供科研等的）树木园
pamphlet	 n. 小册子
excursion	 n. 偏移；远足；短程旅行；离题；游览，游览团
demonstrate	 v. 证明；展示；论证
inherent	 adj. 固有的；内在的；与生俱来的，遗传的
contour	 n. 轮廓；等高线；周线；电路；概要 v. 画轮廓；画等高线
prologue	 n. 开场白；序言 vt. 加上…前言；为…作序
transient	 adj. 短暂的；路过的 n. 瞬变现象；过往旅客；候鸟
billion	 n. 十亿；大量 num. 十亿 adj. 十亿的
enlist	 v. 支持；从军；应募；赞助
precocious	 adj. 早熟的；过早发育的
licit	 adj. 正当的，合法的
extrovert	 n. 外向；外倾者；性格外向者（等于extravert）
linguist	 n. 语言学家
glacier	 n. 冰河，冰川
emigrate	 v. 移居；移居外国
explosion	 n. 爆炸；爆发；激增
vicious	 adj. 恶毒的；恶意的；堕落的；有错误的；品性不端的；剧烈的 n. (Vicious)人名；(英)维舍斯
passive	 adj. 被动的，消极的；被动语态的 n. 被动语态
obstreperous	 adj. 吵闹的，喧嚣的；难驾驭的
forfeit	 n. 罚金；没收物；丧失的东西 adj. 因受罚而丧失的；被没收的 v. （因犯罪、失职、违约等）丧失（权利、名誉、生命等）
embellish	 v. 修饰；装饰；润色
rancor	 n. 深仇；怨恨；敌意
blockade	 v. 封锁 n. 阻塞
gaucherie	 n. 笨拙；无礼
quorum	 n. 法定人数
onerous	 adj. 繁重的；麻烦的；负有义务的；负有法律责任的
extraneous	 adj. 外来的；没有关联的；来自体外的
tube	 n. 管；电子管；隧道；电视机 v. 使成管状；把…装管；用管输送
prosecutor	 n. 检察官；公诉人；[法] 起诉人；实行者
acoustics	 n. 声学；音响效果，音质
compulsion	 n. 强制；强迫；强制力
inclination	 n. 倾向，爱好；斜坡
exotic	 adj. 异国的；外来的；异国情调的
appreciable	 adj. 可感知的；可评估的；相当可观的
photography	 n. 摄影；摄影术
impulse	 n. 冲动；[电子] 脉冲；刺激；神经冲动；推动力 vt. 推动
facility	 n. 设施；设备；容易；灵巧
equidistant	 adj. 等距的；距离相等的
rail	 n. 铁轨；扶手；横杆；围栏 v. 抱怨；责骂
definite	 adj. 一定的；确切的
rile	 v. 激怒；搅浑；惹怒 n. (Rile)人名；(塞)里莱
stagnant	 adj. 停滞的；不景气的；污浊的；迟钝的
baleful	 adj. 恶意的；有害的
denude	 v. 剥夺；使裸露
boorish	 adj. 粗野的；粗鲁的；粗鄙的；笨拙的；乡土气的
attenuate	 adj. 减弱的；稀薄的；细小的 v. 使减弱；使纤细
quixotic	 adj. 唐吉诃德式的；狂想家的；愚侠的
vinery	 n. 葡萄园，葡萄温室
perfidious	 adj. 背信弃义的；不忠的
impinge	 v. 撞击；侵犯
germinate	 v. 使发芽；使生长
vaudeville	 n. 杂耍；轻歌舞剧；歌舞杂耍表演
glutinous	 adj. 粘的；粘性的；胶状的
supple	 adj. 柔软的；灵活的；顺从的；易弯曲的；逢迎的 v. 使柔软；使顺从 n. (Supple)人名；(意、西)苏普莱
desiccant	 adj. 去湿的，使干燥的 n. [助剂] 干燥剂
edify	 v. 熏陶；启发；教诲
sedition	 n. 暴动；煽动性的言论或行为；妨害治安
invoke	 v. 调用；祈求；引起；恳求
belie	 v. 掩饰；与…不符；使失望；证明…虚假错误
commodious	 adj. 宽敞的；方便的
unparalleled	 adj. 无比的；无双的；空前未有的
subliminal	 adj. [生理] 阈下的；潜在意识的；微小得难以察觉的 n. 潜意识；阈下意识
tension	 n. 张力，拉力；紧张，不安；电压 vt. 使紧张；使拉紧
epitomize	 v. 摘要；概括；成为…的缩影
quarterly	 adj. 季度的，按季度的；一年四次的 adv. 按季度，[农] 一季一次地；纵横四分地 n. 季刊
flask	 n. [分化] 烧瓶；长颈瓶，细颈瓶；酒瓶，携带瓶
sober	 adj. 冷静的，清醒的；未醉的 v. 使严肃；使醒酒，使清醒 n. (Sober)人名；(英)索伯
specious	 adj. 似是而非的；外表美观的；华而不实的；徒有其表的
exultant	 adj. 非常高兴的；欢跃的；狂喜的；欢欣鼓舞的
inclement	 adj. 险恶的；气候严酷的；狂风暴雨的
antipodes	 n. 地球上处于正相对应的两个地区，尤指（与欧洲形成对跖地的）澳大拉西亚
belay	 v. 把缆绳拴在系索栓上 n. (Belay)人名；(法)贝莱
declaim	 v. 慷慨陈词；演讲；朗读
jocose	 adj. 诙谐的；开玩笑的
possessive	 adj. 占有的；所有的；所有格的；占有欲强的 n. 所有格
satiate	 v. 充分满足；使厌腻 adj. 饱足的；厌腻的
misbehave	 v. 作弊；行为不礼貌
tricycle	 n. [车辆] 三轮车
anatomy	 n. 解剖；解剖学；剖析；骨骼
xenophobe	 n. 仇外；害怕生人者；畏惧和憎恨外国人的人
devastate	 v. 毁灭；毁坏
agile	 adj. 敏捷的；机敏的；活泼的
sedative	 n. [药] 镇静剂；能使安静的东西；止痛药 adj. 使镇静的；使安静的
vie	 v. 争；竞争 n. (Vie)人名；(英)维
legislator	 n. 立法者
satire	 n. 讽刺；讽刺文学，讽刺作品
respondent	 adj. 回答的；应答的 n. [法] 被告；应答者
pediatrics	 n. 小儿科
satirize	 v. 讽刺；挖苦
exhausted	 adj. 疲惫的；耗尽的 v. 耗尽；用尽；使…精疲力尽（exhaust的过去式）
contempt	 n. 轻视，蔑视；耻辱
hideous	 adj. 可怕的；丑恶的
guilty	 adj. 有罪的；内疚的
obtuse	 adj. 迟钝的；圆头的；不锋利的
anachronistic	 adj. 时代错误的
table	 n. 桌子；表格；平地层 v. 制表；搁置；嵌合 adj. 桌子的
prescript	 adj. 规定的；有时效的 n. 规定；命令
imbibe	 v. 吸收，接受；喝；吸入
adduce	 v. 举出；引证
boiling	 adj. 沸腾的；激昂的 n. 沸腾；煮沸；起泡 adv. 沸腾
unwitting	 adj. 不知情的；不知不觉的，无意的 v. 使精神错乱；使丧失智能（unwit的ing形式）
diffident	 adj. 羞怯的；缺乏自信的；谦虚谨慎的
motto	 n. 座右铭，格言；箴言
cube	 n. 立方；立方体；骰子 v. 使成立方形；使自乘二次；量…的体积
frenetic	 adj. 狂热的；发狂的 n. 疯子；狂人
benefactor	 n. 恩人；捐助者；施主
inkling	 n. 暗示；略知；模糊概念 v. 暗示 （inkle的ing形式）；略知；低声说出
matriarchy	 n. 母权制；女家长制；女族长制；母系氏族
impasse	 n. 僵局；死路
query	 n. 疑问，质问；疑问号 ；[计] 查询 v. 询问；对……表示疑问
expurgate	 v. 删除，删去
enamor	 v. 使迷恋，使倾心
dual	 adj. 双的；双重的 n. 双数；双数词
fanatic	 n. 狂热入迷者；盲信者；盲信 adj. 狂热的；盲信的
particle	 n. 颗粒；[物] 质点；极小量；小品词
sapid	 adj. 有滋味的；有趣的
repellent	 adj. 排斥的；防水的；弹回的；令人讨厌的 n. 防护剂；防水布；排斥力
feudal	 adj. 封建制度的；领地的；世仇的
velocity	 n. 【物】速度
fake	 n. 假货；骗子；假动作 v. 捏造；假装…的样子 adj. 伪造的
simplify	 v. 简化；使单纯；使简易
recur	 v. 复发；重现；采用；再来；循环；递归
crestfallen	 adj. 垂头丧气的，气馁的
algebra	 n. 代数学
autarchy	 n. 专制，独裁；专制国家
gigantic	 adj. 巨大的，庞大的
desert	 v. 遗弃；放弃；逃跑 n. 沙漠；荒原；应得的赏罚 adj. 沙漠的；荒凉的；不毛的
cantonment	 n. 宿营地；兵营
decagon	 n. [数] 十角形；[数] 十边形
caption	 n. 标题；字幕；说明；逮捕 v. 加上说明；加上标题
unbiased	 adj. 公正的；无偏见的
crystal	 n. 结晶，晶体；水晶；水晶饰品 adj. 水晶的；透明的，清澈的
demolish	 v. 拆除；破坏；毁坏；推翻；驳倒
prattle	 v. 闲聊；胡说；小孩般说话 n. 无聊话；咿咿呀呀声
effrontery	 n. 厚颜无耻
cardiac	 n. 强心剂；强胃剂 adj. 心脏的；心脏病的；贲门的
afterthought	 n. 事后的想法；后来添加的东西
vainglorious	 adj. 虚荣心强的；非常自负的
vermin	 n. 害虫；寄生虫；歹徒
disburse	 v. 支付；支出
advertiser	 n. 广告客户；刊登广告的人
diplomat	 n. 外交家，外交官；有外交手腕的人；处事圆滑机敏的人
affable	 adj. 和蔼可亲的；友善的
genre	 n. 类型；种类；体裁；样式；流派；风俗画 adj. 风俗画的；以日常情景为主题的
sector	 n. 部门；扇形，扇区；象限仪；函数尺 vt. 把…分成扇形
virile	 adj. 男性的；有男子气概的；刚健的 n. (Virile)人名；(意)维里莱
cortex	 n. [解剖] 皮质；树皮；果皮
ascendant	 n. 优势；运星；支配地位 adj. 上升的；优越的
pretension	 n. 自负；要求；主张；借口；骄傲
anthropology	 n. 人类学
preclude	 v. 排除；妨碍；阻止
discomfit	 v. 挫败；扰乱，破坏；使…为难；使…破灭
lasting	 adj. 持久的；永恒的 n. [纺] 厚实斜纹织物 v. 持续；维持（last的ing形式）
interposition	 n. 干涉，介入；插入，放入
justification	 n. 理由；辩护；认为有理，认为正当；释罪
appertain	 v. 属于；和……有关，有关系
stymie	 v. 从中作梗，阻挠；妨碍 n. 妨碍球
audition	 n. 听力，听觉；试听 v. 试听；试音
misfortune	 n. 不幸；灾祸，灾难
characterize	 v. 描绘…的特性；具有…的特征
positive	 adj. 积极的；[数] 正的，[医][化学] 阳性的；确定的，肯定的；实际的，真实的；绝对的 n. 正数；[摄] 正片
work	 n. 工作；[物] 功；产品；操作；职业；行为；事业；工厂；著作；文学、音乐或艺术作品 v. 使工作；操作；经营；使缓慢前进
recrudescent	 adj. 复发的，再发作的
celebrated	 adj. 著名的；有名望的 v. 庆祝（celebrate的过去式和过去分词）
dialect	 n. 方言，土话；同源语；行话；个人用语特征 adj. 方言的
global	 adj. 全球的；总体的；球形的
platitude	 n. 陈词滥调；平凡；陈腐
restrict	 v. 限制；约束；限定
annihilate	 v. 歼灭；战胜；废止
landmark	 n. [航]陆标；地标；界标；里程碑；纪念碑；地界标；划时代的事 adj. 有重大意义或影响的
appall	 v. 使胆寒；使惊骇
righteous	 adj. 正义的；正直的；公正的
prostrate	 adj. 俯卧的；拜倒的；降伏的；沮丧的 v. 使…屈服；将…弄倒；使…俯伏
promote	 v. 促进；提升；推销；发扬
torturous	 adj. 折磨人的，痛苦的
conditional	 adj. 有条件的；假定的 n. 条件句；条件语
cryptic	 adj. 神秘的，含义模糊的；[动] 隐藏的
racy	 adj. 生动的；保持原味的；适于赛跑的；猥亵的 n. (Racy)人名；(葡、阿拉伯)拉西
encompass	 v. 包含；包围，环绕；完成
brandish	 v. 挥舞；炫耀 n. 挥舞
pulley	 n. 滑轮；皮带轮；滑车 vt. 用滑轮升起
herbivore	 n. [动] 食草动物
enfranchise	 v. 给予选举权；给予自治权；解放，释放
malfeasance	 n. 渎职，违法行为；不正当，坏事
botany	 n. 植物学；地区植物总称
precedence	 n. 优先；居先
alloy	 v. 使成合金；使减低成色 n. 合金
cursory	 adj. 粗略的；草率的；匆忙的
forebode	 v. 预示；预感；预兆
allot	 v. 分配；拨给；分派 n. (Allot)人名；(英)阿洛特；(西)阿略特；(法)阿洛
serum	 n. 血清；浆液；免疫血清；乳清；树液
congenial	 adj. 意气相投的；性格相似的；适意的；一致的
flame	 n. 火焰；热情；光辉 v. 焚烧；泛红
minute	 n. 分，分钟；片刻，一会儿；备忘录，笔记；会议记录 v. 将…记录下来 adj. 微小的，详细的 [maɪˈnjuːt; US -ˈnuːt; maɪˋnut]
paralyze	 v. 使麻痹；使瘫痪
protuberate	 v. 伸出的
graph	 n. 图表；曲线图 v. 用曲线图表示
outdo	 v. 超过；胜过
dipper	 n. 长柄勺；浸染工；[鸟] 河鸟
retroactive	 adj. 追溯的；有追溯效力的；反动的
defraud	 v. 欺骗
wintry	 adj. 寒冷的，冬天的；冷淡的
cupidity	 n. 贪心，贪婪
retrench	 v. 删除；减少；紧缩开支
foreshadow	 v. 预示；成为…的前兆 n. 预兆
antitoxin	 n. 抗毒素；抗毒素血清
retaliate	 v. 报复；回敬
contentment	 n. 满足；满意
moderate	 adj. 稳健的，温和的；适度的，中等的；有节制的 v. 变缓和，变弱
visceral	 adj. 内脏的；出于本能的；发自肺腑的；粗俗的
stolid	 adj. 迟钝的；缺乏热情的；冷漠的
electroscope	 n. [电] 验电器
complaisance	 n. 殷勤；彬彬有礼；柔顺
genesis	 n. 发生；起源
exculpate	 v. 开脱；使无罪
clan	 n. 宗族；部落；集团
accomplice	 n. 同谋者，[法] 共犯
savage	 adj. 野蛮的；残酷的；狂怒的；荒凉的 n. 未开化的人；粗鲁的人；残暴成性的人 v. 乱咬；粗暴的对待
fortuitous	 adj. 偶然的，意外的；幸运的
frizzle	 v. 使卷缩；使卷曲 n. 卷发；吱吱响声
preservation	 n. 保存，保留
tantamount	 adj. 同等的；相当于…的
unawares	 adv. 不知不觉地；出其不意地；不料
photon	 n. [物] 光子；辐射量子；见光度（等于light quantum）
lascivious	 adj. 好色的；淫荡的；挑动情欲的
external	 adj. 外部的；表面的；[药] 外用的；外国的；外面的 n. 外部；外观；外面
portray	 v. 描绘；扮演
seminary	 n. 神学院；学校；发源地；高级中学
minnow	 n. [鱼] 鲦鱼（一种小淡水鱼）
obsolescent	 adj. 荒废的；即将过时的；逐渐被废弃的
academic	 adj. 学术的；理论的；学院的 n. 大学生，大学教师；学者
incorporate	 v. 包含，吸收；体现；把……合并 adj. 合并的；一体化的；组成公司的
refer	 v. 参考；涉及；提到；查阅
auxiliary	 n. 助动词；辅助者，辅助物；附属机构 adj. 辅助的；副的；附加的
rebuke	 v. 指责，非难；制止；使相形见绌 n. 非难，指责；谴责，鞭策
condense	 v. 浓缩；凝结
buttress	 n. 扶壁；拱壁；支撑物 v. 支持；以扶壁支撑
microphone	 n. 扩音器，麦克风
contentious	 adj. 诉讼的；有异议的，引起争论的；爱争论的
duplicate	 v. 复制；使加倍 n. 副本；复制品 adj. 复制的；二重的
mansion	 n. 大厦；宅邸
intoxicate	 v. 使陶醉；使喝醉；使中毒
insightful	 adj. 有深刻见解的，富有洞察力的
numerator	 n. 分子；计算者；计算器
neutral	 adj. 中立的，中性的；中立国的；非彩色的 n. 中立国；中立者；非彩色；齿轮的空档
gruesome	 adj. 可怕的；阴森的
ratification	 n. 批准；承认，认可
divers	 adj. 不同种类的，各式各样的 n. (Divers)人名；(英)戴弗斯；(法)迪韦尔
divert	 v. 转移；使…欢娱；使…转向 n. (Divert)人名；(法)迪韦尔
bygone	 adj. 过去的 n. 过去的事
fawn	 v. 奉承 n. 小鹿；浅黄褐色；小动物 adj. 浅黄褐色的
resumption	 n. 恢复；重新开始；取回；重获；恢复硬币支付
besmirch	 v. 弄污；损害；诽谤
vex	 v. 使烦恼；使困惑；使恼怒
intermit	 v. 使中断
trickery	 n. 欺骗；诡计；奸计
ostracize	 v. 放逐；排斥；按贝壳流放法放逐
perceive	 v. 察觉，感觉；理解；认知
jargon	 n. 行话，术语；黄锆石
liquefy	 v. 液化；溶解
divest	 v. 剥夺；使脱去，迫使放弃
detract	 v. 转移，使分心
emphasis	 n. 重点；强调；加强语气
liberate	 v. 解放；放出；释放
subtlety	 n. 微妙；敏锐；精明
coherent	 adj. 连贯的，一致的；明了的；清晰的；凝聚性的；互相耦合的；粘在一起的
materialist	 n. 唯物主义者；实利主义者
juvenile	 adj. 青少年的；幼稚的 n. 青少年；少年读物
recoil	 v. 畏缩；弹回；报应 n. 畏缩；弹回；反作用
ensure	 v. 保证，确保；使安全
waver	 v. 摇曳；踌躇；摆动 n. 动摇；踌躇；挥动者
cartridge	 n. 弹药筒，打印机的（墨盒）；[摄] 暗盒；笔芯；一卷软片
censure	 v. 责难，责备 n. 责难
revitalize	 v. 使…复活；使…复兴；使…恢复生气
dullard	 n. 笨蛋；愚人
edible	 adj. 可食用的 n. 食品；食物
sonar	 n. 声纳；声波定位仪（等于asdic）
salubrious	 adj. 清爽的；气候有益健康的
utility	 n. 实用；效用；公共设施；功用 adj. 实用的；通用的；有多种用途的
bass	 n. 鲈鱼；男低音；低音部；椴树 adj. 低音的
unduly	 adv. 过度地；不适当地；不正当地
base	 n. 基础；底部；垒 adj. 卑鄙的；低劣的 v. 以…作基础
grisly	 adj. 可怕的；厉害的；严重的
rehabilitate	 v. 使康复；使恢复名誉；使恢复原状
coincide	 v. 一致，符合；同时发生
raucous	 adj. 沙哑的；刺耳的；粗声的
predominate	 v. 支配，主宰；在…中占优势
bask	 v. 晒太阳；取暖；愉快或舒适 n. (Bask)人名；(芬)巴斯克
coefficient	 n. [数] 系数；率；协同因素 adj. 合作的；共同作用的
hesitant	 adj. 迟疑的；踌躇的；犹豫不定的
conviction	 n. 定罪；确信；证明有罪；确信，坚定的信仰
precursor	 n. 先驱，前导
qualify	 v. 限制；使具有资格；证明…合格
extenuate	 v. 减轻；低估；为…找借口；使人原谅
rustic	 adj. 乡村的；纯朴的；粗野的；手工粗糙的 n. 乡下人；乡巴佬
bounce	 n. 跳；弹力；活力 v. 弹跳；使弹起
bane	 n. 毒药；祸害；灭亡的原因
overwork	 v. 工作过度 n. 过度工作
retrospective	 adj. 回顾的；怀旧的；可追溯的 n. 回顾展
boatswain	 n. 水手长
empiricism	 n. 经验主义；经验论
terminal	 n. 末端；终点；终端机；极限 adj. 末端的；终点的；晚期的
diversion	 n. 转移；消遣；分散注意力
interlocutor	 n. 对话者；谈话者
specimen	 n. 样品，样本；标本
mythology	 n. 神话；神话学；神话集
invasion	 n. 入侵，侵略；侵袭；侵犯
squabble	 v. 发生口角；大声争吵 n. 争吵；口角
dissever	 v. 使分离；使分裂
peccant	 adj. 犯罪的；有过失的
widespread	 adj. 普遍的，广泛的；分布广的
effuse	 v. 流出；涌出；泻出 adj. [植] 疏展的
corrosion	 n. 腐蚀；腐蚀产生的物质；衰败
derogate	 v. 减损；贬损
vital	 adj. 至关重要的；生死攸关的；有活力的 n. (Vital)人名；(法、德、意、俄、葡)维塔尔；(西)比塔尔
mandatory	 adj. 强制的；托管的；命令的 n. 受托者（等于mandatary）
cognizant	 adj. 审理的；已认知的
allusion	 n. 暗示；提及
orbit	 n. 轨道；眼眶；势力范围；生活常规 v. 盘旋；绕轨道运行
furlough	 n. 休假；暂时解雇；放假 v. 准假；暂时解雇
blatant	 adj. 喧嚣的；公然的；炫耀的；俗丽的
subjection	 n. 隶属；服从；征服
disorder	 n. 混乱；骚乱 v. 使失调；扰乱
accustomed	 adj. 习惯的；通常的；独有的 v. 使习惯于（accustom的过去分词）
rebuff	 n. 断然拒绝；回绝；漠不关心 v. 断然拒绝
aerate	 v. 充气；让空气进入；使暴露于空气中
deteriorate	 v. 恶化，变坏
miasma	 n. 瘴气；臭气；不良影响
bile	 n. 胆汁；愤怒
auricular	 adj. 耳的；耳状的
bilk	 v. 欺骗，诈骗；使受挫折；赖帐 n. 诈骗；骗子；赖帐
evidence	 n. 证据，证明；迹象；明显 v. 证明
stimulus	 n. 刺激；激励；刺激物
credo	 n. 信条，教义
blaze	 v. 在树皮上刻路标；公开宣布 n. 火焰，烈火；光辉；情感爆发
embargo	 v. 禁止出入港口；禁止或限制贸易；征用或扣押 n. 禁令；禁止；封港令
algae	 n. [植] 藻类；[植] 海藻
vacate	 v. 空出，腾出；辞职；休假
blight	 n. 枯萎病；荒芜 v. 破坏；使…枯萎
gallant	 adj. 英勇的，勇敢的；华丽的；雄伟的 n. (Gallant)人名；(法)加朗；(英)加伦特
vocative	 adj. 呼格的；称呼的 n. 呼格
homily	 n. 说教；训诫
complementary	 adj. 补足的，补充的
predominant	 adj. 主要的；卓越的；支配的；有力的；有影响的
derange	 v. 扰乱；使错乱；使发狂
emphasize	 v. 强调，着重
timorous	 adj. 胆怯的；胆小的；羞怯的
complaint	 n. 抱怨；诉苦；疾病；委屈
indistinct	 adj. 模糊的，不清楚的；朦胧的；难以清楚辨认的
impenitent	 n. 顽固的人；不知悔改的人 adj. 顽固的；不知悔改的
law	 n. 法律；规律；法治；法学；诉讼；司法界 vi. 起诉；控告 vt. 控告；对…起诉
coax	 v. 哄；哄诱；慢慢将…弄好
precision	 n. 精度，[数] 精密度；精确 adj. 精密的，精确的
constant	 adj. 不变的；恒定的；经常的 n. [数] 常数；恒量
witchcraft	 n. 巫术；魔法
amiable	 adj. 和蔼可亲的，亲切的 n. (Amiable)人名；(法)阿米亚布勒；(英)阿米娅布尔
maverick	 n. 没打烙印的动物；持不同意见的人 vt. 用不正当手段获取 vi. 迷途；背离 adj. 未打烙印的；行为不合常规的；特立独行的
disrupt	 v. 破坏；使瓦解；使分裂；使中断；使陷于混乱 adj. 分裂的，中断的；分散的
foible	 n. 弱点；小缺点；癖好
pseudonym	 n. 笔名；假名
acid	 n. 酸；<俚>迷幻药 adj. 酸的；讽刺的；刻薄的
source	 n. 来源；水源；原始资料
retrieve	 v. [计] 检索；恢复；重新得到 n. [计] 检索；恢复，取回
obligate	 v. 使负义务；强使，强迫；对…施以恩惠 adj. 有责任的，有义务的；必需的
botanize	 v. 研究植物；采集植物 n. 研究并采集植物
knighthood	 n. 骑士；骑士身份
vitamin	 n. [生化] 维生素；[生化] 维他命
meager	 adj. 贫乏的；瘦的 n. 兆
thermal	 adj. 热的；热量的；保热的 n. 上升的热气流
plaudit	 n. 喝彩；赞美
shrubbery	 n. 灌木；[林] 灌木林
deliberate	 adj. 故意的；深思熟虑的；从容的 v. 仔细考虑；商议
habitable	 adj. 可居住的；适于居住的
brotherhood	 n. 兄弟关系；手足情谊；四海之内皆兄弟的信念
acne	 n. [皮肤] 痤疮，[皮肤] 粉刺
cue	 n. 提示，暗示；线索 v. 给…暗示
convey	 v. 传达；运输；让与
troubadour	 n. 行吟诗人；民谣歌手
undersize	 adj. 不够大的；小于一般尺寸的 n. 尺寸不足
rotation	 n. 旋转；循环，轮流
audacious	 adj. 无畏的；鲁莽的
redound	 v. 有助于；报偿，报应；被转移
intolerable	 adj. 无法忍受的；难耐的
dispel	 v. 驱散，驱逐；消除（烦恼等）
wile	 vt. 欺骗，诱骗；消遣 n. 诡计，阴谋
maudlin	 adj. 感情脆弱的；容易流泪的；酒后伤感的 n. 伤感；易流泪
reproof	 n. 责备；谴责
luminary	 n. 发光体；杰出人物；知识渊博的人
numerous	 adj. 许多的，很多的
privacy	 n. 隐私；秘密；隐居；隐居处
secretive	 adj. 秘密的；偷偷摸摸的；促进分泌的
antenna	 n. [电讯] 天线；[动] 触角，[昆] 触须
reconsider	 v. 重新考虑；重新审议
wily	 adj. 狡猾的；诡计多端的 n. (Wily)人名；(英)威利
compliant	 adj. 顺从的；服从的；应允的
forbearance	 n. 自制，忍耐；宽容
dehydration	 n. 脱水
gypsy	 n. 吉卜赛人；吉卜赛语；像吉布赛的人；歌舞剧中的歌舞队员 adj. 象吉卜赛人的；吉卜赛人的；无照的 vi. 流浪
incident	 n. 事件，事变；插曲 adj. [光] 入射的；附带的；易发生的，伴随而来的
virtual	 adj. [计] 虚拟的；实质上的，事实上的（但未在名义上或正式获承认）
foresight	 n. 先见，远见；预见；深谋远虑
debacle	 n. 崩溃；灾害；解冻
entangle	 v. 使纠缠；卷入；使混乱
playful	 adj. 开玩笑的；幽默的；爱嬉戏的
lecherous	 adj. 好色的；淫荡的；引起淫欲的
beatitude	 n. 祝福；至福
preceding	 adj. 在前的；前述的 v. 在之前（precede的ing形式）
quip	 n. 妙语；嘲弄；讽刺语 v. 嘲弄；讥讽
dexterity	 n. 灵巧；敏捷；机敏
susceptible	 adj. 易受影响的；易感动的；容许…的 n. 易得病的人
predatory	 adj. 掠夺的，掠夺成性的；食肉的；捕食生物的
excavate	 v. 挖掘；开凿
symbolize	 v. 象征；用符号表现
perplexing	 adj. 复杂的，令人费解的；令人困惑的
depot	 n. 仓库；停车场；航空站 vt. 把…存放在储藏处 adj. 药性持久的
macabre	 adj. 可怕的；以死亡为主题的；令人毛骨悚然的（等于macaber）
probability	 n. 可能性；机率；[数] 或然率
introvert	 v. 使内向；使内倾；使内弯 n. 内向的人；内翻的东西
ardor	 n. 热情；狂热；灼热
primitive	 adj. 原始的，远古的；简单的，粗糙的 n. 原始人
baffle	 v. 使…困惑；使…受挫折；用挡板控制 n. 挡板；困惑
fertile	 adj. 富饶的，肥沃的；能生育的
portion	 n. 部分；一份；命运 v. 分配；给…嫁妆
reactionary	 adj. 保守的，反动的；反动主义的；反对改革的 n. 反动分子；反动派；保守派
diversity	 n. 多样性；差异
hone	 n. 磨刀石；想念；抱怨 v. 用磨刀石磨
unfavorable	 adj. 不宜的；令人不快的；不顺利的
vendor	 n. 卖主；小贩；供应商；[贸易] 自动售货机
acme	 n. 顶点，极点；最高点
yummy	 adj. 好吃的；美味的；愉快的 n. 美味的东西；令人喜爱的东西
amenity	 n. 舒适；礼仪；愉快；便利设施
populous	 adj. 人口稠密的；人口多的
verisimilar	 adj. 好像是真的
workmanship	 n. 手艺，工艺；技巧
frequent	 adj. 频繁的；时常发生的；惯常的 v. 常到，常去；时常出入于
anomaly	 n. 异常；不规则；反常事物
extraordinary	 adj. 非凡的；特别的；离奇的；临时的；特派的
secede	 v. 脱离；退出
outcry	 n. 强烈抗议；大声疾呼；尖叫；倒彩
gainsay	 v. 反驳；否定 n. 否认；反对
magnification	 n. 放大；放大率；放大的复制品
littoral	 adj. 沿海的；海滨的 n. 沿海地区（等于litora）
omission	 n. 疏忽，遗漏；省略；冗长
inflammatory	 adj. 炎症性的；煽动性的；激动的
auricle	 n. 耳廓；外耳；心耳
devour	 v. 吞食；毁灭
asexual	 adj. [生物] 无性的；无性生殖的
recalcitrant	 adj. 反抗的；反对的；顽强的 n. 顽抗者；不服从的人
debunk	 v. 揭穿；拆穿…的假面具；暴露
carnivorous	 adj. 食肉的；肉食性的
embroil	 v. 使卷入；使混乱
narrative	 n. 叙述；故事；讲述 adj. 叙事的，叙述的；叙事体的
segment	 v. 分割 n. 段；部分
variation	 n. 变化；[生物] 变异，变种
defect	 n. 缺点，缺陷；不足之处 v. 变节；叛变
aforesaid	 adj. 前述的，上述的
exert	 v. 运用，发挥；施以影响
revoke	 v. 撤回，取消；废除 n. 有牌不跟
ambivalent	 adj. 矛盾的；好恶相克的
vocation	 n. 职业；天职；天命；神召
peerless	 adj. 无与伦比的；出类拔萃的；无比的
preferable	 adj. 更好的，更可取的；更合意的
presumption	 n. 放肆，傲慢；推测
census	 v. 实施统计调查 n. 人口普查，人口调查
minus	 prep. 减，减去 n. 负号，减号；不足；负数 adj. 减的；负的
tirade	 n. 激烈的长篇演说
labyrinth	 n. 迷宫；[解剖] 迷路；难解的事物
circumnavigate	 v. 环航
empower	 v. 授权，允许；使能够
depth	 n. [海洋] 深度；深奥
condemn	 v. 谴责；判刑，定罪；声讨
fainthearted	 adj. 懦弱的，胆小的；无精神的
panic	 n. 恐慌，惊慌；大恐慌 adj. 恐慌的；没有理由的 v. 使恐慌
synthesize	 v. 合成；综合
intricate	 adj. 复杂的；错综的，缠结的
remnant	 n. 剩余 adj. 剩余的
acerbic	 adj. 尖刻的（等于acerb）；酸的；辛辣的
aeronautics	 n. 航空学；飞行术
laconic	 adj. 简洁的，简明的
misbehavior	 n. 品行不端；不礼貌（等于misbehaviour）
randomly	 adv. 随便地，任意地；无目的地，胡乱地；未加计划地
ultimatum	 n. 最后通牒；最后结论；基本原理
reassure	 v. 使…安心，使消除疑虑
lackadaisical	 adj. 懒洋洋的；无精打采的；伤感的
anterior	 adj. 前面的；先前的
affray	 n. 滋事；骚乱；争论
erode	 v. 腐蚀，侵蚀
potion	 n. 一剂；一服；饮剂
sedentary	 adj. 久坐的；坐惯的；定栖的；静坐的
animadversion	 n. 批评；非难；评语
misinterpret	 v. 曲解，误解
alto	 n. 女低音；男声最高音；中音乐器 adj. 中音部的
leaflet	 n. 小叶；传单
interpose	 v. 提出（异议等）；使插入；使干涉
anemometer	 n. 风力计，[气象] 风速计
munificent	 adj. 慷慨的；丰厚的；宽宏的
vocabulary	 n. 词汇；词表；词汇量
bawl	 v. 大叫；放声痛哭 n. 叫骂声
demographic	 adj. 人口统计学的；人口学的
blazon	 v. 宣布；装饰 n. 纹章；描绘
laggard	 adj. 落后的；迟钝的；迟缓的 n. 落后者；迟钝者
excoriate	 v. 严厉的责难；擦破的皮肤
convenient	 adj. 方便的；[废语]适当的；[口语]近便的；实用的
genial	 adj. 亲切的，友好的；和蔼的；适宜的
subterfuge	 n. 托词；借口；诡计
meditate	 v. 考虑；计划；企图
characteristic	 adj. 典型的；特有的；表示特性的 n. 特征；特性；特色
bungle	 v. 笨手笨脚地做；把…搞糟 n. 粗劣；失败；笨拙
aspire	 v. 渴望；立志；追求
drudgery	 n. 苦工，苦差事
photosynthesis	 n. 光合作用
disclaim	 v. 否认，拒绝；放弃，弃权；拒绝承认
insulator	 n. [物] 绝缘体；从事绝缘工作的工人
inevitable	 adj. 必然的，不可避免的
enrapture	 v. 使狂喜；使著迷
baldness	 n. 光秃；率直；枯燥
equipment	 n. 设备，装备；器材
abject	 adj. 卑鄙的；可怜的；不幸的；（境况）凄惨的，绝望的
dissension	 n. 纠纷；意见不合；争吵；倾轧
validate	 v. 证实，验证；确认；使生效
utopian	 adj. 乌托邦的；空想的；理想化的 n. 空想家；乌托邦的居民
vertigo	 n. 晕头转向，[临床] 眩晕
recruit	 n. 招聘；新兵；新成员 v. 补充；聘用；征募；使…恢复健康
sear	 v. 烤焦；使…枯萎 adj. 枯萎的；烤焦的 n. 烙印；烧焦痕迹
beset	 v. 困扰；镶嵌；围绕
battalion	 n. 营，军营；军队，部队
torpor	 n. 不活泼；麻木；懒散，迟缓
rigorous	 adj. 严格的，严厉的；严密的；严酷的
stupendous	 adj. 惊人的；巨大的
commission	 n. 委员会；佣金；犯；委任；委任状 v. 委任；使服役；委托制作
bureau	 n. 局，处；衣柜；办公桌
barring	 prep. 除非；不包括；除…以外 v. 阻拦（bar的ing形式） n. (Barring)人名；(德)巴林
fickle	 adj. 浮躁的；易变的；变幻无常的
gnash	 v. 咬牙切齿 n. 咬
ignoble	 adj. 不光彩的；卑鄙的；卑贱的
static	 adj. 静态的；静电的；静力的 n. 静电；静电干扰
vexation	 n. 苦恼；恼怒；令人烦恼的事
insensate	 adj. 无感觉的；无情的；无生命的
hamper	 v. 妨碍；束缚；使困累 n. 食盒，食篮；阻碍物
narcissism	 n. [心理] 自恋，自我陶醉
conscious	 adj. 意识到的；故意的；神志清醒的
aloof	 adj. 冷淡的；远离的；冷漠的 adv. 远离；避开地
antecede	 v. 在之前；胜过；居前
exaggerate	 v. 使扩大；使增大
graphic	 adj. 形象的；图表的；绘画似的
expatriate	 v. 使移居国外；流放，放逐；使放弃国籍 n. 被流放者；移居国外者 adj. 移居国外的；被流放的
daunt	 v. 使气馁，使畏缩；威吓 n. (Daunt)人名；(英)当特
adorn	 v. 装饰；使生色 n. (Adorn)人名；(泰)阿隆
subdivide	 v. 细分，再分
resurgent	 adj. 复活的；复苏的 n. 复活者
apposite	 adj. 适当的；贴切的
remission	 n. 缓解；宽恕；豁免
serviceable	 adj. 有用的，可供使用的；耐用的
lengthy	 adj. 漫长的，冗长的；啰唆的
kismet	 n. 天命；命运
immutable	 adj. 不变的；不可变的；不能变的
pedestal	 n. 基架，基座；基础 vt. 搁在台上；支持；加座
unsavoury	 adj. 难吃的；令人讨厌的
proficient	 adj. 熟练的，精通的 n. 精通；专家，能手
license	 n. 执照，许可证；特许 v. 许可；特许；发许可证给
communicative	 adj. 交际的；爱说话的，健谈的；无隐讳交谈的
landlord	 n. 房东，老板；地主
diffusion	 n. 扩散，传播；[光] 漫射
lifetime	 n. 一生；寿命；终生；使用期 adj. 一生的；终身的
autumnal	 adj. 秋天的；已过中年的
plaintiff	 n. 原告
seed	 n. 种子；根据；精液；萌芽；子孙；原由 v. 播种；结实；成熟；去…籽
litigious	 adj. 好诉讼的；好争论的
oxide	 n. [化学] 氧化物
prevaricate	 v. 搪塞；支吾其辞，闪烁其辞
original	 n. 原件；原作；原物；原型 adj. 原始的；最初的；独创的；新颖的
periodicity	 n. [数] 周期性；频率；定期性
suppress	 v. 抑制；镇压；废止
orifice	 n. [机] 孔口
auditory	 n. 听众；礼堂 adj. 听觉的；耳朵的
implicate	 v. 使卷入；涉及；暗指；影响
progeny	 n. 子孙；后裔；成果
synonym	 n. 同义词；同义字
doctrinaire	 adj. 教条主义的；空谈理论的 n. 教条主义者；空论家，纯理论家
coy	 adj. 腼腆的；忸怩作态的；怕羞的 vi. 忸怩作态 vt. 爱抚 n. (Coy)人名；(法)库瓦；(英、德、西)科伊
discretion	 n. 自由裁量权；谨慎；判断力；判定；考虑周到
somnolent	 adj. 催眠的，想睡的
rapprochement	 n. 友好；恢复邦交；友善关系的建立
compunction	 n. 悔恨，后悔；内疚
acquiesce	 v. 默许；勉强同意
scrupulous	 adj. 细心的；小心谨慎的；一丝不苟的
resilient	 adj. 弹回的，有弹力的
vibration	 n. 振动；犹豫；心灵感应
replica	 n. 复制品，复制物
devious	 adj. 偏僻的；弯曲的；不光明正大的
cacophonous	 adj. 粗腔横调的；发音不和谐的
dauntless	 adj. 无畏的；勇敢的；不屈不挠的
prudent	 adj. 谨慎的；精明的；节俭的 n. (Prudent)人名；(法)普吕当
cylinder	 n. 圆筒；汽缸；[数] 柱面；圆柱状物
beneficent	 adj. 慈善的；善行的
vehement	 adj. 激烈的，猛烈的；热烈的
period	 n. 周期，期间；时期；月经；课时；（语法学）句点，句号 adj. 某一时代的
scribe	 n. 抄写员；作家；划线器 v. 写下，记下；用划线器划
thesis	 n. 论文；论点
ambrosial	 adj. 特别美味的；芬香的
prankster	 n. 爱开玩笑的人；顽皮的人；恶作剧的人
sound	 v. 听（诊）；测量，测…深；使发声；试探；宣告 n. 声音，语音；噪音；海峡；吵闹；听力范围；[医] 探条 adj. 健全的，健康的；合理的；可靠的；有效彻底的 adv. 彻底地，充分地
crest	 n. [物] 波峰；冠；山顶；顶饰 v. 到达绝顶；形成浪峰
simile	 n. 明喻；直喻
neutron	 n. [核] 中子
abomination	 n. 厌恶；憎恨；令人厌恶的事物
christen	 v. 为…命名；为…施洗礼 n. (Christen)人名；(法、德、西、丹、挪)克里斯滕；(英)克里森
exorbitant	 adj. （要价等）过高的；（性格等）过分的；不在法律范围之内的
acreage	 n. 面积，英亩数
hurricane	 n. 飓风，暴风
hirsute	 adj. 多毛的；[昆] 有粗毛的
arrant	 adj. 极恶的；声名狼藉的；彻头彻尾的
glycerol	 n. [有化] 甘油；丙三醇
clairvoyance	 n. 千里眼；异常的洞察力
telepathy	 n. 心灵感应；传心术
inspire	 v. 激发；鼓舞；启示；产生；使生灵感
censor	 v. 审查，检查；检查和删节 n. 检查员；[心理] 潜意识压抑力；信件检查员
profile	 n. 侧面；轮廓；外形；剖面；简况 v. 描…的轮廓；扼要描述
reactor	 n. [化工] 反应器；[核] 反应堆；起反应的人
contrition	 n. 痛悔；悔悟
unilateral	 adj. 单边的；[植] 单侧的；单方面的；单边音；（父母）单系的
vernal	 adj. 春天的；和煦的；青春的
condensation	 n. 冷凝；凝结；压缩；缩合聚合
callow	 adj. 年轻而无经验的；羽毛未丰的 n. (Callow)人名；(英)卡洛
fluent	 adj. 流畅的，流利的；液态的；畅流的
cabinet	 n. 内阁；橱柜；展览艺术品的小陈列室 adj. 内阁的；私下的，秘密的
approval	 n. 批准；认可；赞成
avocation	 n. 副业；业余爱好；嗜好
precession	 n. 岁差（等于precession of the equinoxes）；先行；优先
coincidence	 n. 巧合；一致；同时发生
arboreal	 adj. 树木的；栖息在树上的
exploit	 v. 开发，开拓；剥削；开采 n. 勋绩；功绩
unit	 n. 单位，单元；装置；[军] 部队；部件
misadventure	 n. 灾难；不幸遭遇
nationality	 n. 国籍，国家；民族；部落
valedictory	 adj. 告别的 n. 告别辞
usage	 n. 使用；用法；惯例
cleanliness	 n. 清洁
gossamer	 n. 蛛丝；薄纱；小蜘蛛网 adj. 轻飘飘的；薄弱的
purgatory	 n. 炼狱；涤罪；暂时的苦难 adj. 涤罪的（等于purgative）
felonious	 adj. 凶恶的；重罪的；极恶的
melodrama	 n. 情节剧；音乐剧；耸人听闻的事件，闹剧
trapezoid	 n. [数] 梯形；[数] 不规则四边形 adj. 梯形的；[数] 不规则四边形的
deficit	 n. 赤字；不足额
dissimilar	 adj. 不同的
brokerage	 n. 佣金；回扣；中间人业务
fracture	 n. 破裂，断裂；[外科] 骨折 v. 破裂；折断
modest	 adj. 谦虚的，谦逊的；适度的；端庄的；羞怯的 n. (Modest)人名；(罗)莫代斯特；(德)莫德斯特；(俄)莫杰斯特
vaporize	 v. 蒸发
prolix	 adj. 冗长的；说话啰嗦的
spectroscope	 n. [光] 分光镜
elocutionist	 n. 演说家；雄辩家；朗诵者
jocular	 adj. 爱开玩笑的；打趣的；滑稽的
focus	 n. 焦点；中心；清晰；焦距 v. 使集中；使聚焦
unused	 adj. 不用的；从未用过的
betrothal	 n. 订婚；婚约
setback	 n. 挫折；退步；逆流
stimulant	 n. [药] 兴奋剂；刺激物；酒精饮料 adj. 激励的；使人兴奋的
dwindle	 v. 减少；变小
greedy	 adj. 贪婪的；贪吃的；渴望的
slender	 adj. 细长的；苗条的；微薄的
outcast	 n. 流浪的人；被驱逐的人 adj. 被遗弃的；无家可归的；被逐出的
curtail	 v. 缩减；剪短；剥夺…特权等
logical	 adj. 合逻辑的，合理的；逻辑学的
transact	 v. 交易；谈判
amenable	 adj. 有责任的：顺从的，服从的；有义务的；经得起检验的
utilize	 v. 利用
educe	 v. 引出；演绎；使显出
loathe	 v. 讨厌，厌恶
foment	 v. 煽动；挑起；热敷
judicious	 adj. 明智的；头脑精明的；判断正确的
straightforward	 adj. 简单的；坦率的；明确的；径直的 adv. 直截了当地；坦率地
anarchy	 n. 无政府状态；混乱；无秩序
polarization	 n. 极化；偏振；两极分化
emancipate	 v. 解放；释放
funnel	 n. 漏斗；烟囱 v. 通过漏斗或烟囱等；使成漏斗形
miscreant	 adj. 异端的；邪道的；极恶的 n. 异端；恶棍；罪大恶极之人
parentage	 n. 出身；亲子关系；门第；起源
torpid	 adj. 迟钝的，迟缓的；不活泼的；麻痹的；[生物] 蛰伏的
galvanize	 v. 镀锌；通电；刺激
pandemic	 adj. （疾病等）（全国、全球i）流行的；普遍的 n. 流行性疾病
antonym	 n. [语] 反义词
gusto	 n. 爱好；由衷的高兴；嗜好
zealot	 n. 狂热者；犹太教狂热信徒
lifelong	 adj. 终身的
gibber	 v. 喋喋而言；胡扯 n. 三棱石；无法听懂的话
furrow	 n. 皱纹；犁沟；车辙 v. 犁；耕；弄绉
mirror	 n. 镜子；真实的写照；榜样 v. 反射；反映
sardonic	 adj. 讽刺的；嘲笑的，冷笑的
ravenous	 adj. 贪婪的；渴望的；狼吞虎咽的
remorseless	 adj. 冷酷的；不知过错的；坚持不懈的；不屈不挠的
chloroplast	 n. [植] 叶绿体
balk	 n. 障碍；错误 v. 阻止；推诿；错过
penetrate	 v. 渗透；穿透；洞察
cache	 n. 电脑高速缓冲存储器；贮存物；隐藏处 v. 隐藏；窖藏
bale	 n. 包；捆；灾祸；不幸 v. 将打包
nurture	 v. 养育；鼓励；培植 n. 养育；教养；营养物
levity	 n. 多变；轻浮；轻率；不稳定
practicable	 adj. 可用的；行得通的；可实行的
transplant	 v. 移植；迁移；使移居 n. 移植；移植器官；被移植物；移居者
leg	 n. 腿；支柱
omnipresent	 adj. 无所不在的
nickel	 n. 镍；镍币；五分镍币 v. 镀镍于
bland	 adj. 乏味的；温和的；冷漠的 vt. 使…变得淡而无味；除掉…的特性 vi. 变得平淡无奇；丧失特性 n. (Bland)人名；(英)布兰德
overleap	 v. 越过；跳过；忽略
fractious	 adj. 易怒的；倔强的，难以对待的
carbohydrate	 n. [有化] 碳水化合物；[有化] 糖类
lethal	 adj. 致命的，致死的 n. 致死因子
radar	 n. [雷达] 雷达，无线电探测器
remote	 adj. 遥远的；偏僻的；疏远的 n. 远程
chord	 n. 弦；和弦；香水的基调
explode	 v. 爆炸，爆发；激增
commonplace	 n. 老生常谈；司空见惯的事；普通的东西 adj. 平凡的；陈腐的
synchronous	 adj. 同步的；同时的
deceive	 v. 欺骗；行骗
antibiotics	 n. [药] 抗生素；抗生学
parochial	 adj. 教区的；狭小的；地方范围的
status	 n. 地位；状态；情形；重要身份
herald	 n. 预兆，征兆；先驱；传令官；报信者 v. 通报；预示…的来临
literature	 n. 文学；文献；文艺；著作
limitation	 n. 限制；限度；极限；追诉时效；有效期限；缺陷
biography	 n. 传记；档案；个人简介
insensible	 adj. 昏迷的；无知觉的；麻木不仁的
endurable	 adj. 能忍耐的；可忍受的；能持久的
preparatory	 adj. 预备的 n. 预科；预备学校
wavelength	 n. [物] 波长
statue	 n. 雕像，塑像 vt. 以雕像装饰
barren	 adj. 贫瘠的；不生育的；无益的；沉闷无趣的；空洞的 n. 荒地
transitory	 adj. 短暂的，暂时的；瞬息的
presentiment	 n. 预感
unkempt	 adj. 蓬乱的，不整洁的；（言语等）粗野的
legislate	 v. 用立法规定；通过立法
barrel	 v. 把……装入桶内 n. 桶；枪管，炮管
output	 n. 输出，输出量；产量；出产 v. 输出
antemundane	 世界形成前的
delineate	 v. 描绘；描写；画…的轮廓
ferocious	 adj. 残忍的；惊人的
laudable	 adj. 值得赞赏的
anticyclone	 n. 反气旋，反旋风；高气压
manometer	 n. 压力计；[流] 测压计；血压计
convert	 v. 使转变；转换…；使…改变信仰 n. 皈依者；改变宗教信仰者
desertification	 n. （土壤）荒漠化；沙漠化（等于desertization）
proscribe	 v. 剥夺……的公权；禁止
solution	 n. 解决方案；溶液；溶解；解答
modicum	 n. 少量，一点点
beatify	 v. 行宣福礼；使享福
transfigure	 v. 使变形；使改观；美化；理想化
veneer	 n. 外表；虚饰；饰面；胶合板的一层；薄木片 v. 胶合；虚饰；给…镶以饰片
devoid	 adj. 缺乏的；全无的
affair	 n. 事情；事务；私事；（尤指关系不长久的）风流韵事
carnivore	 n. [动] 食肉动物；食虫植物
pellucid	 adj. 透明的；清晰的；明了的
blase	 adj. 玩厌了的，厌烦于享乐的 n. (Blase)人名；(德)布拉泽；(法)布拉斯
transverse	 adj. 横向的；横断的；贯轴的 n. 横断面；贯轴；横肌
veracious	 adj. 诚实的；真实的
coalescence	 n. 合并；联合；接合
purport	 v. 声称；意图；意指；打算 n. 意义，主旨；意图
participate	 v. 参与，参加；分享
ceremonious	 adj. 隆重的；讲究仪式的；正式的
unspeakable	 adj. 无法形容的；不能以言语表达的；坏透了的
anachronism	 n. 时代错误；不合潮流的人或物
abnormal	 adj. 反常的，不规则的；变态的
pressure	 n. 压力；压迫，[物] 压强 v. 迫使；密封；使……增压
palpable	 adj. 明显的；可感知的；易觉察的
excerpt	 n. 摘录，引用 v. 引用，摘录
aerial	 adj. 空中的，航空的；空气的；空想的 n. [电讯] 天线
embarrass	 v. 使局促不安；使困窘；阻碍
kinsfolk	 n. 亲属；家属
regimen	 n. [医] 养生法；生活规则；政体；支配
Calvinism	 n. 加尔文主义；加尔文教派
ampere	 n. 安培（计算电流强度的标准单位）
coil	 v. 盘绕，把…卷成圈 n. 线圈；卷
hesitation	 n. 犹豫
berth	 n. 卧铺；停泊处，锚位；差事 v. 使……停泊；为……提供铺位
evict	 v. 驱逐；逐出
punitive	 adj. 惩罚性的；刑罚的
ebb	 n. 衰退；退潮；衰落 v. 衰退；减少；衰落；潮退
revelation	 n. 启示；揭露；出乎意料的事；被揭露的真相
triumph	 n. 胜利，凯旋；欢欣 v. 获得胜利，成功
oblivious	 adj. 遗忘的；健忘的；不注意的；不知道的
principal	 adj. 主要的；资本的 n. 首长；校长；资本；当事人
spider	 n. 蜘蛛；设圈套者；三脚架
tremor	 n. [医] 震颤；颤动
frantic	 adj. 狂乱的，疯狂的
conduit	 n. [电] 导管；沟渠；导水管
pyre	 n. 火葬用的柴堆
duplicity	 n. 口是心非；表里不一；不诚实
conflagration	 n. 大火；快速燃烧；突发；冲突
supplicant	 n. 恳求者，乞求者
tutorship	 n. 辅导；教师职位
capitulate	 v. 认输，屈服；屈从，停止反抗；有条件投降；让步
despotic	 adj. 暴虐的，暴君的；专横的
withstand	 v. 抵挡；禁得起；反抗
stringent	 adj. 严格的；严厉的；紧缩的；短缺的
jubilation	 n. 喜欢；庆祝；欢呼
ratio	 n. 比率，比例
persuade	 v. 说服，劝说；使某人相信；劝某人做（不做）某事 adj. 空闲的，有闲的
upbraid	 v. 责骂；训斥
appendage	 n. 附加物；下属；[动][解剖] 附器（如植物的枝叶和动物的腿尾）
averse	 adj. 反对的；不愿意的
senator	 n. 参议员；（古罗马的）元老院议员；评议员，理事
ingratiate	 v. 使迎合；使讨好；使逢迎
exuberant	 adj. 繁茂的；生气勃勃的，充溢的
perjure	 v. 作伪证；使发伪誓；使破坏誓言
nude	 adj. 裸的，裸体的；无装饰的；与生俱有的 n. 裸体；裸体画
peak	 n. 山峰；最高点；顶点；帽舌 v. 使达到最高点；使竖起 adj. 最高的；最大值的
reprieve	 v. 缓期执行；暂时解救 n. 暂缓；缓刑
ignominious	 adj. 可耻的；下流的
midway	 n. 中途；娱乐场 adj. 中途的 adv. 中途
affluence	 n. 富裕；丰富；流入；汇聚
emaciated	 adj. 瘦弱的；憔悴的 v. 憔悴；消瘦下去（emaciate的过去分词）
aqueduct	 n. [水利] 渡槽；导水管；沟渠
collage	 n. 抽象拚贴画（用报纸、布、压平的花等碎片拼合而成的） vt. 把…创作成拼贴画，拼贴
unveil	 v. 使公之于众，揭开；揭幕
disastrous	 adj. 灾难性的；损失惨重的；悲伤的
vestige	 n. 遗迹；残余；退化的器官
tabulate	 adj. 平板状的；有平面的 v. 使成平面；把…制成表格
needlework	 n. 刺绣，缝纫；女红的作品
fraternal	 adj. 兄弟般的；友好的
commemorate	 v. 庆祝，纪念；成为…的纪念
repine	 v. 抱怨；不满
unanimous	 adj. 全体一致的；意见一致的；无异议的
alienate	 v. 使疏远，离间；让与
unscrupulous	 adj. 肆无忌惮的；寡廉鲜耻的；不讲道德的
volume	 n. 量；体积；卷；音量；大量；册 adj. 大量的 vi. 成团卷起 vt. 把…收集成卷
debase	 v. 降低；使…贬值；掺杂 n. (Debase)人名；(意)德巴塞
precede	 v. 领先，在…之前；优于，高于
disagreeable	 adj. 不愉快的；厌恶的；不为人喜的；难相处的；脾气坏的
heinous	 adj. 可憎的；极凶恶的
distressed	 adj. 痛苦的；忧虑的；贫困的；受损的 v. 使痛苦；使紧张；使困苦（distress的过去分词）
expression	 n. 表现，表示，表达；表情，脸色，态度，腔调，声调；式，符号；词句，语句，措辞，说法
successor	 n. 继承者；后续的事物
counselor	 n. 顾问；法律顾问；参事（等于counsellor）
supplicate	 v. 恳求，哀求；恳请
ossify	 v. 骨化；硬化；僵化
ablution	 n. 洗礼；洗澡（常用复数）；斋戒沐浴
balance	 n. 平衡；余额；匀称 v. 使平衡；结算；使相称
propagate	 v. 传播；传送；繁殖；宣传
approximately	 adv. 大约，近似地；近于
sufficiency	 n. 足量，充足；自满
collide	 v. 碰撞；抵触，冲突
squalid	 adj. 肮脏的；污秽的；卑劣的
distillation	 n. 精馏，蒸馏，净化；蒸馏法；精华，蒸馏物
superb	 adj. 极好的；华丽的；宏伟的 n. (Superb)人名；(罗)苏佩尔布
contemptible	 adj. 可鄙的；卑劣的；可轻视的
breakdown	 n. 故障；崩溃；分解；分类；衰弱；跺脚曳步舞
accountant	 n. 会计师；会计人员
colloquial	 adj. 白话的；通俗的；口语体的
impale	 v. 刺穿；钉住；使绝望
reclusive	 adj. 隐居的；隐遁的
jingoism	 n. 侵略主义；沙文主义；武力外交政策
ratify	 v. 批准；认可
collier	 n. 矿工；运煤船
brooch	 n. （女用的）胸针，领针
bemoan	 v. 惋惜；为…恸哭
arguable	 adj. 可论证的；可议的；可疑的
nitrogen	 n. [化学] 氮
legislative	 adj. 立法的；有立法权的 n. 立法权；立法机构
workmanlike	 adj. 技术熟练的；精工细作的
multiplication	 n. [数] 乘法；增加
natal	 adj. 出生的；诞生的；分娩的；出生地的 n. (Natal)人名；(英、法、西、葡)纳塔尔
redirect	 v. 使改方向；重新寄送 adj. 再直接的 n. 再直接询问
Catholicism	 n. 天主教；天主教义
defendant	 adj. 辩护的；为自己辩护的 n. 被告
abnegate	 v. 放弃；舍弃；禁忌
treacherous	 adj. 奸诈的，叛逆的，背叛的；危险的；不牢靠的
parallel	 n. 平行线；对比 v. 使…与…平行 adj. 平行的；类似的，相同的
diameter	 n. 直径
uniform	 adj. 统一的；一致的；相同的；均衡的；始终如一的 n. 制服 v. 使穿制服；使成一样
abdomen	 n. 腹部；下腹；腹腔
stimulate	 v. 刺激；鼓舞，激励
nadir	 n. 最低点，最底点；[天] 天底
indefinitely	 adv. 不确定地，无限期地；模糊地，不明确地
replicate	 v. 复制；折叠 adj. 复制的；折叠的 n. 复制品；八音阶间隔的反覆音
discriminate	 v. 歧视；区别；辨别
foretell	 v. 预言；预示；预告
irate	 adj. 生气的；发怒的
curmudgeon	 n. 脾气坏的人，乖戾的人；吝啬鬼；存心不良的人
endue	 v. 授予，赋予；穿上
numerical	 adj. 数值的；数字的；用数字表示的（等于numeric）
extol	 v. 颂扬；赞美；赞颂
olfactory	 adj. 嗅觉的；味道的 n. 嗅觉器官
electrolyte	 n. 电解液，电解质；电解
fabulous	 adj. 难以置信的；传说的，寓言中的；极好的
choir	 n. 唱诗班；合唱队；舞蹈队 v. 合唱
ruinous	 adj. 破坏性的，毁灭性的；零落的
aborigine	 n. 土著；土著居民
hundredth	 adj. 第一百的；一百分之一的 n. 第一百，第一百个；百分之一
intriguing	 adj. 有趣的；迷人的 v. 引起…的兴趣；策划阴谋；私通（intrigue的ing形式）
acerbity	 n. 酸，涩；刻薄
sympathetic	 adj. 同情的；交感神经的；共鸣的；赞同的；和谐的；合意的 n. 交感神经；容易感受的人
swerve	 v. 转弯；突然转向；背离 n. 转向；偏离的程度
whim	 n. 奇想；一时的兴致；怪念头；幻想
determinate	 adj. 确定的；决定的 vt. 确定；弄清楚
coagulate	 v. 使…凝结
capillary	 n. 毛细管 adj. 毛细管的；毛状的
biped	 adj. 有两足的 n. 两足动物
supplant	 v. 代替；排挤掉
tenacious	 adj. 顽强的；坚韧的；固执的；紧握的；黏着力强的
laser	 n. 激光
effervescent	 adj. 冒泡的，沸腾的；兴奋的
assuage	 v. 平息；缓和；减轻
occupant	 n. 居住者；占有者
gene	 n. [遗] 基因，遗传因子
frigid	 adj. 寒冷的，严寒的；冷淡的
recreant	 n. 懦夫；叛徒 adj. 胆小的；怯懦的；不忠的
pompous	 adj. 自大的；浮夸的；华而不实的；爱炫耀的
theorem	 n. [数] 定理；原理
antiquary	 n. 古文物研究者；古董商人；收集古文物者
clothier	 n. 衣庄；呢绒商
dormancy	 n. [生物] 休眠，冬眠；[生物] 蛰伏
exoskeleton	 n. [昆] 外骨骼
geometry	 n. 几何学
impetus	 n. 动力；促进；冲力
bronchus	 n. 支气管
glamorize	 v. 美化；使有魅力
proliferate	 v. 增殖；扩散；激增
absolve	 v. 免除；赦免；宣告…无罪
bethink	 v. 想起，忆起；使……思考；使……考虑
amplitude	 n. 振幅；丰富，充足；广阔
antiquate	 v. 废弃；使…过时；使…具有古旧形式或风格 adj. 过时的；旧式的
series	 n. 系列，连续；[电] 串联；级数；丛书
condenser	 n. 冷凝器；[电] 电容器；[光] 聚光器
desultory	 adj. 断断续续的；散漫的；不连贯的，无条理的
interval	 n. 间隔；间距；幕间休息
pernicious	 adj. 有害的；恶性的；致命的；险恶的
caste	 n. （印度社会中的）种姓；（具有严格等级差别的）社会地位；（排他的）社会团体
principle	 n. 原理，原则；主义，道义；本质，本义；根源，源泉
inspiring	 adj. 鼓舞人心的；灌输的；启发灵感的 v. 鼓舞；激发；使感悟（inspire的ing形式）
adjustment	 n. 调整，调节；调节器
animadvert	 v. 批判；非难；责备
withdraw	 v. 撤退；收回；撤消；拉开
extortion	 n. 勒索；敲诈；强夺；被勒索的财物
amorphous	 adj. 无定形的；无组织的；[物] 非晶形的
semiannual	 adj. 一年两次的；半年一次的
realism	 n. 现实主义；实在论；现实主义的态度和行为
vagabond	 adj. 流浪的；流浪者的；浪荡的；漂泊的 n. 流浪者；浪子；流氓；懒汉 v. 到处流浪
immune	 adj. 免疫的；免于……的，免除的 n. 免疫者；免除者
subsequent	 adj. 后来的，随后的
indiscreet	 adj. 轻率的；不慎重的
homage	 n. 敬意；尊敬；效忠
outcome	 n. 结果，结局；成果
valorous	 adj. 勇敢的；勇武的
irritable	 adj. 过敏的；急躁的；易怒的
apposition	 n. 并置，同格；同位语
beguile	 v. 欺骗；使着迷；轻松地消磨
amorous	 adj. 多情的；恋爱的；热情的；色情的
overrun	 n. 泛滥成灾；超出限度 v. 泛滥；超过；蹂躏
amok	 adv. 狂乱地；杀人狂地 adj. 杀人狂的；狂乱的
commingle	 v. 使混合；掺和
dismiss	 v. 解散；解雇；开除；让离开；不予理会、不予考虑
cacophony	 n. 刺耳的音调；不和谐音
atom	 n. 原子
prowess	 n. 英勇；超凡技术；勇猛
selective	 adj. 选择性的
recreate	 v. 娱乐；消遣
wearisome	 adj. 使疲倦的；使厌倦的；乏味的
abrade	 v. 擦伤；磨损
lethargy	 n. 昏睡；死气沉沉；嗜眠（症）
politic	 adj. 精明的；有策略的；狡猾的；审慎的；政治的 vi. 拉选票
armada	 n. （西班牙的）无敌舰队
incessant	 adj. 不断的；不停的；连续的
humiliate	 v. 羞辱；使…丢脸；耻辱
niggardly	 adj. 小气的；很少量的 adv. 小气地；很少量地
conciliatory	 adj. 安抚的；调和的；调停的
ration	 v. 配给；定量供应 n. 定量；口粮；配给量
velvety	 adj. 天鹅绒般柔软的；醇和的，可口的
preposterous	 adj. 荒谬的；可笑的
pious	 adj. 虔诚的；敬神的；可嘉的；尽责的
flag	 v. 标记；衰退；枯萎 n. 标志；旗子
liquid	 adj. 液体的；清澈的；明亮的；易变的 n. 液体，流体；流音
permanent	 adj. 永久的，永恒的；不变的 n. 烫发（等于permanent wave）
plethora	 n. 过多；过剩；[医] 多血症
bibliomania	 n. 藏书癖；（尤指珍本书）收藏狂
vociferous	 adj. 大声叫的；喊叫的，喧嚷的
adjunct	 n. 附属物；助手；修饰语 adj. 附属的
transpire	 v. 发生；蒸发；泄露
hemorrhage	 n. [病理] 出血（等于haemorrhage）；番茄汁 v. [病理] 出血
gravity	 n. 重力，地心引力；严重性；庄严
utilitarian	 adj. 功利的；功利主义的；实利的 n. 功利主义者
acquiescence	 n. 默许；默从
frivolous	 adj. 无聊的；轻佻的；琐碎的
polytechnic	 adj. 各种工艺的；综合技术的 n. 工艺学校；理工专科学校
demise	 n. 死亡，终止；转让；传位 vt. 遗赠；禅让
pantomime	 n. 哑剧；舞剧；手势 v. 打手势；演哑剧
shroud	 n. 寿衣；覆盖物；船的横桅索；[电] 护罩 v. 覆盖；包以尸衣
eccentric	 adj. 古怪的，反常的 n. 古怪的人
laud	 v. 赞美；称赞 n. 赞美；称赞；颂歌
betimes	 adv. 及时，准时；早
suspect	 n. 嫌疑犯 adj. 可疑的；不可信的 v. 怀疑；猜想
bilingual	 adj. 双语的 n. 通两种语言的人
recluse	 n. 隐士；隐居者 adj. 隐居的
subjacent	 adj. 在底下的；在下级的
studious	 adj. 用功的；热心的；专心的；故意的；适于学习的
begrudge	 v. 羡慕，嫉妒；吝惜，舍不得给
judicature	 n. 司法；法官；司法权；法官的职位
gullible	 adj. 易受骗的；轻信的
facsimile	 n. 传真；复写 adj. 复制的 v. 传真；临摹
violation	 n. 违反；妨碍，侵害；违背；强奸
jade	 n. 翡翠；[宝] 碧玉；老马 adj. 玉制的；绿玉色的 v. 疲倦
transition	 n. 过渡；转变；[分子生物] 转换；变调
whet	 v. 刺激；磨快；促进 n. 磨；开胃物；刺激物
section	 n. 截面；部分；部门；地区；章节 v. 被切割成片；被分成部分
lave	 v. 洗；沐浴；冲刷 n. 剩余物
witling	 n. 玩弄小聪明的人
embezzle	 v. 盗用；挪用；贪污
absorb	 v. 吸收；吸引；承受；理解；使…全神贯注
cessation	 n. 停止；中止；中断
kudos	 n. 荣誉；名望；称赞
influx	 n. 流入；汇集；河流的汇集处
summary	 adj. 简易的；扼要的 n. 概要，摘要，总结
chattel	 n. 动产；奴隶（常用复数）
tangential	 adj. [数] 切线的，[数] 正切的；离题的，扯远的 n. 正切，切线
reclamation	 n. 开垦；收回；再利用；矫正
socialize	 v. 使社会化；使社会主义化；使适应社会生活
comport	 v. 行为；举动
unsettle	 v. 使动摇；使不安定；使心神不宁
misstep	 n. 失足；过失；踏错；失策 vi. 失足；走上歧途
hexagon	 n. 六角形，六边形 adj. 成六角的；成六边的
urgency	 n. 紧急；催促；紧急的事
felicity	 n. 幸福；快乐；幸运
infinitesimal	 adj. 无穷小的；无限小的；极小的 n. 无限小；极微量；极小量
reprehend	 v. 申斥；指责 n. 责备
subsidize	 v. 资助；给与奖助金；向…行贿
antiquarian	 adj. 古文物研究的；古文物的 n. 古文物研究者；[古] 古文物收藏家
panacea	 n. 灵丹妙药；万能药
cordial	 adj. 热忱的，诚恳的；兴奋的 n. 补品；兴奋剂；甜香酒，甘露酒
amass	 v. 积聚，积累
option	 n. [计] 选项；选择权；买卖的特权
exhale	 v. 呼气；发出；发散；使蒸发
volatile	 adj. [化学] 挥发性的；不稳定的；爆炸性的；反复无常的 n. 挥发物；有翅的动物
bronchitis	 n. [内科] 支气管炎
contend	 v. 竞争；奋斗；斗争；争论
entreaty	 n. 恳求；乞求
nebulous	 adj. 朦胧的；星云的，星云状的
bight	 n. 海湾，绳圈；曲线
momentous	 adj. 重要的；重大的
catalog	 n. [图情][计] 目录；登记 v. 登记；为…编目录
cell	 n. 细胞；电池；蜂房的巢室；单人小室 vi. 住在牢房或小室中
moo	 v. 发出哞哞声 n. 牛叫声
severely	 adv. 严重地；严格地，严厉地；纯朴地
pedal	 v. 踩踏板；骑车 n. 踏板；脚蹬子 adj. 脚的；脚踏的
quietus	 n. 解除；偿清；生命的终止；寂灭
importunate	 adj. 强求的，纠缠不休的
salutary	 adj. 有益的，有用的；有益健康的
aberration	 n. 失常；离开正路，越轨
inestimable	 adj. 无价的；难以估计的
insatiable	 adj. 贪得无厌的；不知足的
shrewd	 adj. 精明的；狡猾的；机灵的 n. 精明（的人）；机灵（的人）
sensational	 adj. 轰动的；耸人听闻的；非常好的；使人感动的
assurance	 n. 保证，担保；（人寿）保险；确信；断言；厚脸皮，无耻
frank	 adj. 坦白的，直率的；老实的 n. 免费邮寄特权 v. 免费邮寄
juxtapose	 v. 并列；并置
data	 n. 数据（datum的复数）；资料
recapture	 v. 夺回；拿回；再体验；政府征收再经历 n. 夺回；取回；政府对公司超额收益或利润的征收
alleged	 adj. 所谓的；声称的；被断言的 v. 宣称（allege的过去式和过去分词）；断言
witness	 n. 证人；目击者；证据 v. 目击；证明；为…作证
entrance	 n. 入口；进入 v. 使出神，使入迷
reprehensible	 adj. 应斥责的；应该谴责的
browbeat	 v. 恫吓，吓唬；欺侮
explicate	 v. 说明，解释
vivacity	 n. 活泼；快活；精神充沛
cabal	 n. 阴谋（尤指政治上的）；阴谋集团 v. 策划阴谋
equation	 n. 方程式，等式；相等；[化学] 反应式
perspicacity	 n. 洞察力；聪颖；睿智
nuance	 n. 细微差别
electrification	 n. 电气化；带电；充电
proton	 n. [物] 质子
bedaub	 v. 俗气地装饰；涂污
beneficence	 n. 慈善；善行；捐款
terminus	 n. 终点；终点站；界标；界石
presage	 n. 预感；前兆 v. 预感；预言
territorial	 adj. 领土的；区域的；土地的；地方的 n. 地方自卫队士兵
navigate	 v. 驾驶，操纵；使通过；航行于
posthumous	 adj. 死后的；遗腹的；作者死后出版的
brag	 n. 吹牛，自夸 v. 吹牛，自夸
brae	 n. 斜坡；山坡
credence	 n. 信任；凭证；祭器台（等于credence table，credenza）
stifle	 v. 扼杀；使窒息；藏匿 n. （马等的）后膝关节；（马等的）[动] 后膝关节病
transmute	 v. 使变形；使变质
pertinacity	 n. 顽固；执拗
altercation	 n. 争执
essence	 n. 本质，实质；精华；香精
oversee	 v. 监督；审查；俯瞰；偷看到，无意中看到
bray	 v. 叫；捣碎 n. 驴叫声；喇叭声
inborn	 adj. 天生的；先天的
blandishment	 n. 奉承；谄媚；哄诱
impropriety	 n. 不适当；不正确；用词错误；[审计] 不正当行为
contemptuous	 adj. 轻蔑的；侮辱的
mirage	 n. 海市蜃楼；幻想，妄想
exhilarate	 v. 使高兴，使振奋；使愉快
emanate	 v. 放射（过去式emanated，过去分词emanated，现在分词emanating，第三人称单数emanates，形容词emanative）；发散
expand	 v. 扩张；使膨胀；详述
hydroxide	 n. [无化] 氢氧化物；羟化物
indigenous	 adj. 本土的；土著的；国产的；固有的
incipient	 adj. 初期的；初始的；起初的；发端的
collapse	 v. 倒塌；瓦解；暴跌 n. 倒塌；失败；衰竭
boisterous	 adj. 喧闹的；狂暴的；猛烈的
maintenance	 n. 维护，维修；保持；生活费用
alternative	 adj. 供选择的；选择性的；交替的 n. 二中择一；供替代的选择
venal	 adj. 贪污的；用金钱买得的；贿赂的；贪赃枉法的 n. (Venal)人名；(英)维纳尔
emerge	 v. 浮现；摆脱；暴露
inalterable	 adj. 不变的；不能变更的
concupiscence	 n. 强烈的邪欲
mediocre	 adj. 普通的；平凡的；中等的
prosaic	 adj. 平凡的，乏味的；散文体的
comparative	 adj. 比较的；相当的 n. 比较级；对手
repel	 v. 击退；抵制；使厌恶；使不愉快
commensurate	 adj. 相称的；同量的；同样大小的
overdose	 v. 配药过量；使过分沉溺 n. 药量过多（等于overdosage）
solace	 n. 安慰；慰藉；安慰之物 v. 安慰；抚慰；使快乐（过去式solaced，过去分词solaced，现在分词solacing，第三人称单数solaces）
clumsy	 adj. 笨拙的
liquor	 n. 酒，含酒精饮料；溶液；液体；烈酒 vi. 喝酒，灌酒 vt. 使喝醉
harangue	 n. 长篇大论；高谈阔论；热烈的演说 v. 向…滔滔不绝地演讲；大声训斥
weight	 n. 重量，重力；负担；砝码；重要性 v. 加重量于，使变重
density	 n. 密度
stratagem	 n. 策略；计谋
perception	 n. 知觉；[生理] 感觉；看法；洞察力；获取
transience	 n. 短暂；无常；顷刻（等于transiency）
carcass	 n. （人或动物的）尸体；残骸；（除脏去头备食用的）畜体
impassive	 adj. 冷漠的；无感觉的
phlegmatic	 adj. 冷淡的；迟钝的；冷漠的
pyromania	 n. 放火狂；纵火癖
withhold	 v. 保留，不给；隐瞒；抑制
elliptical	 adj. 椭圆的；省略的
galore	 adv. 丰富地 adj. 丰富的；大量的
bumptious	 adj. 傲慢的；瞎自夸的
pedestrian	 adj. 徒步的；缺乏想像力的 n. 行人；步行者
nefarious	 adj. 邪恶的；穷凶极恶的；不法的
pillory	 v. 给…上颈手枷；使…惹人嘲笑 n. 示众；颈手枷；使惹人嘲笑
incisive	 adj. 深刻的；敏锐的；锋利的
aspirant	 n. 有抱负的人；野心家 adj. 上进的；有野心的
injurious	 adj. 有害的；诽谤的
ameliorate	 v. 改善；减轻（痛苦等）；改良
scarcity	 n. 不足；缺乏
illusion	 n. 幻觉，错觉；错误的观念或信仰
humid	 adj. 潮湿的；湿润的；多湿气的
proclamation	 n. 公告；宣布；宣告；公布
gloat	 v. 幸灾乐祸；心满意足地注视 n. 幸灾乐祸；贪婪的盯视；洋洋得意
vortex	 n. [航][流] 涡流；漩涡；（动乱，争论等的）中心；旋风
vogue	 n. 时尚；流行，时髦 adj. 时髦的，流行的
admonition	 n. 警告
cholera	 n. [内科] 霍乱
cohesive	 adj. 凝聚的；有结合力的；紧密结合的；有粘着力的
cadence	 n. 节奏；韵律；抑扬顿挫
elude	 v. 逃避，躲避
omnipotent	 adj. 无所不能的；全能的；有无限权力的
hackneyed	 adj. 陈腐的；平庸的 v. 出租（马匹、马车等）；役使（hackney的过去式）
coagulant	 n. [建][化工] 促凝剂；凝血剂；凝结剂
reverent	 adj. 虔诚的；恭敬的；尊敬的
sinister	 adj. 阴险的；凶兆的；灾难性的；左边的
dilatory	 adj. 拖拉的；缓慢的，不慌不忙的
aggregate	 v. 集合；聚集；合计 n. 合计；集合体；总计 adj. 聚合的；集合的；合计的
preponderate	 v. （在重量、数量、力量等方面）占优势
altitude	 n. 高地；高度；[数] 顶垂线；（等级和地位等的）高级；海拔
perceptive	 adj. 感知的，知觉的；有知觉力的
obstruct	 v. 妨碍；阻塞；遮断
discountenance	 v. 使丢脸；不赞成；使慌张 n. 不赞成
center	 n. 中心，中央；中锋；中心点 v. 居中，被置于中心 adj. 中央的，位在正中的
ether	 n. 乙醚；[有化] 以太；苍天；天空醚
advisory	 adj. 咨询的；顾问的；劝告的 n. 报告；公告
behold	 v. 看；注视；把视为 int. 瞧；看呀
prerogative	 n. 特权 adj. 有特权的
irreparable	 adj. 不能挽回的；不能修补的
soluble	 adj. [化学] 可溶的，可溶解的；可解决的
cohesion	 n. 凝聚；结合；[力] 内聚力
awkward	 adj. 尴尬的；笨拙的；棘手的；不合适的
ascent	 n. 上升；上坡路；登高
ambitious	 adj. 野心勃勃的；有雄心的；热望的；炫耀的
imaginative	 adj. 富于想象的；有创造力的
tempt	 v. 诱惑；引起；冒…的风险；使感兴趣
pipette	 n. 移液管；吸移管 vt. 用移液器吸取
celibate	 n. 独身者 adj. 独身的；禁欲的
brevity	 n. 简洁，简短；短暂，短促
intentional	 adj. 故意的；蓄意的；策划的
overwhelming	 adj. 压倒性的；势不可挡的 v. 压倒；淹没（overwhelm的ing形式）；制服
culmination	 n. 顶点；高潮
malignancy	 n. 恶性（肿瘤等）；恶意
impair	 v. 损害；削弱；减少
reaction	 n. 反应，感应；反动，复古；反作用
collaboration	 n. 合作；勾结；通敌
habitude	 n. 习俗；习惯
attest	 v. 证明；证实；为…作证
stingy	 adj. 吝啬的，小气的；有刺的；缺乏的
overpass	 vt. 超越；胜过；忽略 n. 天桥；陆桥
circumlocution	 n. 婉转曲折的说法，累赘的陈述；遁辞
proctor	 n. 代理人；学监 v. 监督
impotent	 adj. 无力的；无效的；虚弱的；阳萎的
contest	 v. 争辩；质疑 n. 竞赛；争夺；争论
escalate	 v. 逐步增强；逐步升高
regnant	 adj. 统治的；占优势的；流行的，广泛的
version	 n. 版本；译文；倒转术
extrude	 v. 挤出，压出；使突出；逐出
rectangle	 n. 矩形；长方形
apprentice	 n. 学徒；生手 v. 使…当学徒
tendency	 n. 倾向，趋势；癖好
acquired	 adj. [医] 后天的；已获得的；已成习惯的 v. 取得；捕获（acquire的过去分词）
smelt	 v. 熔炼，冶炼；精炼 n. 香鱼；胡瓜鱼
elongate	 v. 拉长；使延长；使伸长 adj. 伸长的；延长的
campaign	 v. 作战；参加竞选；参加活动 n. 运动；活动；战役
alchemy	 n. 点金术；魔力
ubiquitous	 adj. 普遍存在的；无所不在的
mastermind	 v. 策划 n. 优秀策划者；才子
voracious	 adj. 贪婪的；贪吃的；狼吞虎咽的
trigger	 v. 引发，引起；触发 n. 扳机；[电子] 触发器；制滑机
corporal	 adj. 肉体的，身体的 n. 下士
blaspheme	 v. 亵渎；咒骂，辱骂
slit	 v. 撕裂；使有狭缝 n. 裂缝；投币口
thermometer	 n. 温度计；体温计
lyric	 adj. 抒情的；吟唱的 n. 抒情诗；歌词
collagen	 n. [生化] 胶原，胶原质
Aluminum	 n. 铝
aeronaut	 n. 飞船或气球驾驶员；飞船或气球乘客
rhetorical	 adj. 修辞的；修辞学的；夸张的
juridical	 adj. 司法的；法院的；裁判上的
aerosol	 n. [物化] 气溶胶；气雾剂；喷雾器；浮质 adj. 喷雾的；喷雾器的
spartan	 adj. 斯巴达的；斯巴达式的；（生活方式）简朴的，清苦的。 n. 斯巴达人；勇士
inveigh	 v. 痛骂；漫骂；猛烈抨击
plebeian	 adj. 平民的；普通的；粗俗的 n. 平民；百姓；粗俗的人
remorse	 n. 懊悔；同情
comprehensible	 adj. 可理解的
spectacle	 n. 景象；场面；奇观；壮观；公开展示；表相，假相 n（复）眼镜
impact	 n. 影响；效果；碰撞；冲击力 v. 挤入，压紧；撞击；对…产生影响
tact	 n. 机智；老练；圆滑；鉴赏力
imprudent	 adj. 轻率的，鲁莽的；不小心的
cooling	 adj. 冷却的 n. 冷却
power	 n. 力量，能力；电力，功率；政权，势力；[数] 幂 v. 激励；供以动力；使…有力量 adj. 借影响有权势人物以操纵权力的
remembrance	 n. 回想，回忆；纪念品；记忆力
dais	 n. 讲台
pastoral	 adj. 牧师的；牧人的；田园生活的；乡村的 n. 牧歌；田园诗；田园景色
hazardous	 adj. 有危险的；冒险的；碰运气的
redolent	 adj. 芬芳的；有…香味的；令人想起…的
irreversible	 adj. 不可逆的；不能取消的；不能翻转的
preponderant	 adj. 占优势的；突出的；压倒性的
cartilage	 n. 软骨
spurious	 adj. 假的；伪造的；欺骗的
misnomer	 n. 用词不当；误称；写错姓名
antiseptic	 adj. 防腐的，抗菌的；非常整洁的 n. 防腐剂，抗菌剂
collective	 adj. 集体的；共同的；集合的；集体主义的 n. 集团；集合体；集合名词
prevalent	 adj. 流行的；普遍的，广传的
queasy	 adj. 呕吐的；不稳定的；催吐的
delusion	 n. 迷惑，欺骗；错觉；幻想
catabolism	 n. [生化] 分解代谢
kiln	 vt. 烧窑；在干燥炉干燥 n. （砖，石灰等的）窑；炉；干燥炉
bide	 v. 等待；面临；禁得起
subjective	 adj. 主观的；个人的；自觉的
monetary	 adj. 货币的；财政的
filter	 v. 滤过；渗入；慢慢传开 n. 滤波器；[化工] 过滤器；筛选；滤光器
incorrigible	 adj. 不可救药的；积习难改的 n. 不可救药的人
chivalry	 n. 骑士精神（复数chivalries）；骑士制度
constituent	 n. 成分；选民；委托人 adj. 构成的；选举的
redoubtable	 adj. 可怕的；令人敬畏的
invaluable	 adj. 无价的；非常贵重的
surrogate	 n. 代理；代用品；遗嘱检验法官 vt. 代理；指定某人为自己的代理人 adj. 代理的；替代的
esophagus	 n. [解剖] 食管；[解剖] 食道
parameter	 n. 参数；系数；参量
dissemble	 v. 掩饰，掩盖；假装
order	 n. 命令；顺序；规则；[贸易] 定单 v. 命令；整理；定购
appellate	 adj. 上诉的；受理上诉的
psychic	 adj. 精神的；心灵的；灵魂的；超自然的 n. 灵媒；巫师
scapegoat	 n. 替罪羊，替人顶罪者；替身 vt. 使成为…的替罪羊
conjecture	 n. 推测；猜想 v. 推测；揣摩
habitual	 adj. 习惯的；惯常的；习以为常的
requisite	 adj. 必备的，必不可少的；需要的 n. 必需品
steadfast	 adj. 坚定的；不变的
exempt	 v. 免除；豁免 adj. 被免除的；被豁免的 n. 免税者；被免除义务者
depreciate	 v. 使贬值；贬低；轻视
aurora	 n. [地物] 极光；曙光
origin	 n. 起源；原点；出身；开端
unisonous	 adj. 同音的；和谐的
surcharge	 n. 超载；额外费 v. 追加罚款；使…装载过多；使…负担过重
flamboyant	 adj. 艳丽的；火焰似的；炫耀的 n. 凤凰木
assiduity	 n. 勤勉；刻苦；殷勤
stratify	 v. 分层；成层；使形成阶层
composure	 n. 镇静；沉着
decisive	 adj. 决定性的；果断的，坚定的
administrator	 n. 管理人；行政官
context	 n. 环境；上下文；来龙去脉
forgery	 n. 伪造；伪造罪；伪造物
insinuate	 v. 暗示；使逐渐而巧妙地取得；使迂回地潜入
clientele	 n. 客户；诉讼委托人
