crayon	 n. 蜡笔
eraser	 n. 橡皮擦
glove	 n. 手套
wallet	 n. 钱包
watch	 n. 表；（通常指）手表
whose	 pron. 谁的
first of all	 首先；第一
lose	 v. (lost) 失去
find	 v. (found) 发现；找到
lost and found box	 失物招领箱
mine	 pron. 我的
yours	 pron. 你（们）的
tape	 n. 录音带；录像带
purple	 adj. 紫色的；紫红色的 n. 紫色；紫红色
hers	 pron. 她的
careful	 adj. 仔细的；认真的；小心的
be careful with	 小心（对待）⋯⋯
on	 adv. 从某时刻起；在使用中；开着的 prep. 在⋯⋯时候 prep. 在⋯⋯河边
from now on	 从现在开始
here is/are ⋯	 （用于刚找到某人或某物时）在这儿
camera	 n. 照相机
phone	 n. 电话；电话机
mobile phone	 移动电话；手机
lost and found office	 失物招领处
in a hurry	 匆匆忙忙
leave	 v. (left) 丢下；遗忘
plane	 n. 飞机
taxi	 n. 出租车
why	 adv. 为什么
airport	 n. 机场；航空港
hundred	 num. 百
hundreds of	 几百；成百上千
look for	 寻找
thousand	 num. 千
strange	 adj. 奇怪的
boat	 n. 船
duck	 n. 鸭
pig	 n. 猪
sausage	 n. 香肠；腊肠
play	 v. 演奏；弹奏
tennis	 n. 网球
piano	 n. 钢琴
ride	 v. (rode) 骑；乘
club	 n. 俱乐部
term	 n. 学期
board	 n. 布告板
would like	 想要；希望
well	 int. 噢；喔
all	 adj. 所有的；全部的
that's all	 仅此而已
worry	 v. 焦虑；担心
worry about	 担心⋯⋯
teach	 v. (taught) 教；讲授
then	 adv. 那么；就
monitor	 n. 班长；监督员
start	 n. 开始；开端
get on well with sb.	 与某人相处融洽
ready	 adj. 乐意的
ready to do sth.	 乐于做某事
promise	 v. 承诺；保证
fast	 adv. 快地；快速地 adj. 快的；快速的
fit	 adj. 健康的；强健的
just	 adv. 就；正好
ball	 n. 球；球类游戏
game	 n. 运动项目
team	 n. 队伍；球队
best	 adj. 最好的
score	 n. 得分；成绩
tidy	 adj. 整齐的；整洁的；爱整洁的；爱整齐的 v. 收拾；整理
sure	 adj. 确信的；有把握的
everybody	 pron. 每个人
just like	 正如；正像
beautiful	 adj. 美的；美丽的
fly	 v. (flew) 放飞（风筝）；飞行；乘飞机
kite	 n. 风筝
swim	 v. (swam) 游泳
go over	 复习；练习
picnic	 n. 野餐
housework	 n. 家务劳动
else	 adv. 其他；另外
nobody	 pron. 没有人
at	 prep. 在⋯⋯点钟
nothing	 pron. 没有什么；没有东西
silly	 adj. 愚蠢的；傻气的
fantastic	 adj. 极好的
forward	 adv. 面向未来的；向前
look forward to	 盼望
fan	 n. 迷；支持者
make friends	 交朋友
shirt	 n. 球衣；（男式）衬衫
cheer	 v. 为⋯⋯喝彩
player	 n. 运动员；选手
hope	 v. 希望
win	 v. (won) 赢；获胜
enjoy oneself	 过的愉快
myself	 pron. 我自己
during	 prep. 在⋯⋯期间
May	 n. 5月
May Day	 五一劳动节
late	 adv. 迟；晚 adj. 迟的；晚的
walk	 n. 步行；走
take a walk	 散步
country	 n. 乡下；乡村
second	 num. 第二
collect	 v. 收集
litter	 n. 垃圾
fun	 n. 娱乐；乐趣
summer holiday	 暑假
camp	 n. 营地；帐篷
Australian	 adj. 澳大利亚的
sightseeing	 n. 观光；游览
go sightseeing	 观光
beach	 n. 海滨；海滩
early	 adv. 早；提前 adj. 早的
chalk	 n. 粉笔
ruler	 n. 直尺
carry	 v. 拿；带
change	 v & n. 改变；变化
everything	 pron. 每样事物；每件事；所有事物
future	 n. 将来；未来
in the future	 将来
life	 n. 生活；生命
need	 v & v aux. 需要
will	 v aux. (would) 将；将要；将会
maybe	 adv. 也许
ask	 v. 询问；问
question	 n. 问题
by	 prep. 用；靠；乘（交通工具）
level	 n. 水平
able	 adj. 能够⋯⋯的
be able to	 能够做⋯⋯
more	 adv. 更加；更 adj. 更多的
not ⋯ any more	 不再⋯⋯
free	 adj. （时间）空闲的；空余的
air	 n. 天空；空中；空气
land	 n. 陆地
machine	 n. 机器
rain	 n. 雨；雨水 v. 下雨
robot	 n. 机器人
sea	 n. 海；海洋
space	 n. 太空；空间
traffic	 n. 交通
jam	 n. 堵塞；拥挤
traffic jam	 交通堵塞
wind	 n. 风
true	 adj. 真的；真实的
come true	 （希望、梦想等）实现，成真
here is/are	 （用于介绍某人或某物）下面
bike (=bicycle)	 n. 自行车
car	 n. 汽车；轿车
cheap	 adj. 便宜的
everywhere	 adv. 到处；处处
not only ⋯ but also ⋯	 不仅⋯⋯而且⋯⋯
into	 prep. 进入⋯⋯里面
long	 adj. 长的；长时间的
heavy	 adj. 繁重的；沉的
light	 adj. 轻的；轻松的；少量的
easy	 adj. 容易的
working	 adj. （有关）工作的
hour	 n. 小时
short	 adj. 短的；短暂的；矮的
rise	 v. 升起；上升
as well	 和；又；也
market	 n. 市场
supermarket	 n. 超市
biscuit	 n. 饼干
lemon	 n. 柠檬
strawberry	 n. 草莓
Mother's Day	 母亲节
size	 n. 尺码；号
take	 v. (took) 穿（某尺寸的衣服或鞋子）
may	 v aux. (might) 可以；可能
try	 v. 尝试；试穿；品尝
try on	 试穿
certainly	 adv. 当然；行
wait a minute	 别急；稍等一会
sale	 n. 降价出售
price	 n. 价格
look	 v. 看起来；显得
fresh	 adj. 新鲜的
advantage	 n. 有利条件；优势
anyone	 pron. 任何人
anything	 pron. 任何东西；任何事情
anywhere	 adv. 在任何地方；往任何地方
compare	 v. 比较
pay	 v. 支付；付钱
post	 n & v. 邮寄
product	 n. 产品
receive	 v. 收到；接到
safe	 adj. 安全的
several	 adj. 几个；一些
online	 adj. 在线的
shopping	 n. 购物
way	 n. 方式；道路
one of ⋯⋯	 之一
almost	 adv. 几乎；差不多
something	 pron. 某事物；某种东西
later	 adv. 后来；以后
open	 adj. 营业的；开放的
out	 adv. 外出；离开
go out	 外出；游玩
over	 prep. 通过；超过
one day	 总有一天
one	 pron. （同一群人或物中）一个
bank	 n. 银行
museum	 n. 博物馆
along	 prep. 沿着
across	 prep. 越过
cross	 v. 穿过
opposite	 prep. 在⋯⋯的对面
tourist	 n. 游客
excuse	 v. 原谅；谅解
excuse me	 劳驾，对不起（用于礼貌地引起某人的注意）
street	 n. 街道
turn	 v. 换方向
third	 num. 第三
guidebook	 n. 导游手册；旅行指南
bookshop	 n. 书店
right	 int. 好了（用于变换话题或活动）；是的；好
Why not ⋯?	 为什么不⋯⋯呢？
could	 v aux. 可以；能
underground	 n. 地铁
Take	 v. 搭乘；乘坐；固定使用；把（某人）带往；使（某人）到
tour	 n. （短期的）参观，游览；旅行
square	 n. 广场
middle	 n. 中部；中间 adj. 中等的；中部的
famous	 adj. 著名的
painting	 n. 油画；绘画
from	 prep. 从⋯⋯出发
metre (AmE meter)	 n. 米
above	 prep. 在⋯⋯上方；在⋯⋯之上
river	 n. 河；江
clear	 adj. （天气）晴朗的
bridge	 n. 桥
railway	 n. 铁路
past	 prep. 路过（某物或某地）；越过
church	 n. 教堂
finish	 v. 结束；完成
high	 adj. 高的
post office	 邮政局
up	 prep. 沿着⋯⋯而去
down	 prep. 沿着
stop	 n. 车站
horse	 n. 马
born	 adj. （动词bear的过去分词）出生
strict	 adj. 严格的；严厉的
friendly	 adj. 友好的
primary	 adj. 初等的；初级的
primary school	 小学
town	 n. 城镇；市镇
US	 美国
hey	 int. 嘿；喂
village	 n. 村庄
nice	 adj. 友好的；亲切的
good	 adj. 乖的；守规矩的
difficult	 adj. 难对付的
bathroom	 n. 浴室
bedroom	 n. 卧室
garden	 n. 花园
living room	 起居室；客厅
east	 adj. 东面的；东部的 n. 东方
coast	 n. 海岸
ago	 adv. 以前
store	 n. 商店
movie theater (BrE theatre)	 电影院
bored	 adj. 厌烦的；厌倦的
president	 n. 总统
comfortable	 adj. 舒适的；舒服的
lake	 n. 湖
last	 adj. （星期、月份等）最近过去的，紧接现在前面的
yesterday	 adv. （在）昨天
hair	 n. 头发
gold	 n. 金色；黄金；金牌
forest	 n. 森林
once	 adv. 一次；一回
upon	 prep. 在⋯⋯上；到⋯⋯上
once upon a time	 从前
decide	 v. 决定
go for a walk	 散步
basket	 n. 篮子
notice	 v. 注意到
all alone	 独自一人的
dark	 adj. 黑暗的
pick	 v. 采；摘
pick up	 拿起；举起
soon	 adv. 立刻；不久
lost	 adj. 迷路的
around	 prep. 环绕着；围绕
little	 adj. 小的
towards	 prep. 往；向；朝⋯⋯方向
knock	 v. 敲
door	 n. 门
answer	 v. 应门；回答
push	 v. 推
enter	 v. 进入
bowl	 n. 碗
hungry	 adj. 感到饿的；饥饿的
Right	 adj. 合适的；恰当的
Finish	 v. 吃完；喝完；用尽
either	 adv. 也（不）
piece	 n. 部分；碎片；一件/个/张
in pieces	 破碎
asleep	 adj. 睡着的
return	 v. 返回；归还
cry	 v. 哭；喊叫
at first	 起初；首先
point	 v. 指向；指
point at	 指着⋯⋯
shout	 v. 高声说；大声喊
jump	 v. 跳
without	 prep. 无；没有
part	 n. 部分；地区；地方
March	 n. 3月
April	 n. 4月
June	 n. 6月
Women's Day	 妇女节
National Day	 国庆节
Children's Day	 儿童节
July	 n. 7月
August	 n. 8月
September	 n. 9月
October	 n. 10月
November	 n. 11月
December	 n. 12月
writer	 n. 作家
find out	 发现；查明；弄清
real	 adj. 真实的；真正的
at the age of	 在⋯⋯岁时
newspaper	 n. 报纸
exact	 adj. 准确的；确切的
date	 n. 日期
become	 v. (became) 成为
in the 1860s	 在19世纪60年代
Play	 n. 剧本；戏剧
poem	 n. 诗歌
marry	 v. 结婚
successful	 adj. 成功的
work	 n. 作品；著作
build	 v. (built) 建造
fire	 n. 火；火灾
die	 v. 死；去世
rich	 adj. 富有的
language	 n. 语言
around the world	 世界各地
young	 adj. 年轻的
Pacific	 adj. 太平洋的
so	 adv. 那么（尤指用于引出新话题）；这么；那么（用于强调质量、感觉或数量）
guess	 v. 猜；猜测
excited	 adj. 激动的；兴奋的
wow	 int. 哇；噢
arrive	 v. 到达
relax	 v. 放松
world-famous	 adj. 举世闻名的
French	 adj. 法国的；法语的 n. 法国人；法语
sell	 v. (sold) 卖；出售
top	 n. 顶端
till	 conj. 直到⋯⋯为止
Light	 n. 电灯
wonderful	 adj. 绝妙的；了不起的
palace	 n. 宫殿
bow	 v. 鞠躬；弯腰
kiss	 v & n. 吻；亲吻
shake	 v. (shook) 摇晃
shake hands	 握手
smile	 v & n. 微笑
British	 adj. 英国的；英国人的
German	 n. 德国人；德语 adj. 德国的；德国人的；德语的
Japanese	 n. 日本人；日语 adj. 日本的；日语的；日本人的
Russian	 n. 俄罗斯人；俄语 adj. 俄罗斯的；俄罗斯人的；俄语的
visitor	 n. 游客；观光者
2ussian	 俄罗斯
what	 int. 什么（表示惊奇）
nod	 v. 点（头）
head	 n. 头；头部
hug	 v. 拥抱；紧抱
each	 pron. 各个；每个
each other	 互相；彼此
India	 印度
together	 adv. 一起；共同
Maori	 adj. 毛利人的
touch	 v. 触摸；接触
nose	 n. 鼻子
finger	 n. 手指
foot	 n. 脚；足 (pl. feet)
knee	 n. 膝盖
leg	 n. 腿
mouth	 n. 嘴；口
body	 n. 身体；躯干
foreign	 adj. 外国的
North American	 北美人
personal	 adj. 个人的
arm	 n. 臂；手臂
arm in arm	 臂挽臂地
South American	 南美人
hold	 v. (held) 握着；使不动
move	 v. 移动
Britain	 不列颠；英国
not at all	 一点也不
polite	 adj. 礼貌的
somewhere	 adv. 某处；某个地方
wave	 v. 挥（手）；招（手）；摆（手）
fact	 n. 事实；细节
in fact	 事实上
rude	 adj. 粗鲁的；无礼的
bring	 v. (brought) 带来
lively	 adj. 活泼的；轻快的
modern	 adj. 现代的
noisy	 adj. 吵闹的
pop (=popular)	 adj. 流行的；受欢迎的
rock	 n. 摇滚乐
sound	 n. 声音
violin	 n. 小提琴
Western	 adj. 西方的
hmm	 int. 嗯
By	 prep. 由⋯⋯创作；被；由
through	 prep. 穿过
both	 pron. 两个；两者
opera	 n. 歌剧
voice	 n. 声音
drum	 n. 鼓
believe	 v. 相信
musician	 n. 乐手；音乐家
centre (AmE center)	 n. 中心
European	 adj. 欧洲的
classical	 adj. 经典的；古典的
century	 n. 世纪
composer	 n. 作曲家
elder	 adj. 年长的
waltz	 n. 华尔兹舞（曲）
dance music	 舞曲
another	 pron. 又一个；再一个
Piece	 n. （写作，音乐或艺术的）作品
poor	 adj. 贫穷的
perfect	 adj. 完美的
sad	 adj. 令人悲伤的；令人难过的
slow	 adj. 慢的
feel	 v. (felt) 感觉；觉得
ship	 n. 船
